"","Player","Span","Mat","Inns","Dis","Ct","St","Ct_Wk","Ct_Fi","MD","DI"
"1","MS Dhoni (INDIA)","2016-2019","34","34","37","21","16","21","0","5 (5ct 0st)","1.088"
"2","DA Miller (SA/World)","2016-2021","39","39","37","36","1","1","35","4 (4ct 0st)","0.948"
"3","Sarfaraz Ahmed (PAK)","2016-2020","41","41","34","26","8","26","0","3 (2ct 1st)","0.829"
"4","SA Edwards (NL)","2018-2019","29","28","28","24","4","24","0","3 (3ct 0st)","1.000"
"5","GH Dockrell (IRE)","2017-2020","38","38","26","26","0","0","26","3 (3ct 0st)","0.684"
"6","MJ Guptill (NZ)","2016-2021","41","40","26","26","0","0","26","3 (3ct 0st)","0.650"
"7","TL Seifert (NZ)","2018-2021","35","35","26","20","6","20","0","3 (3ct 0st)","0.742"
"8","JC Buttler (ENG)","2016-2021","35","35","25","22","3","21","1","3 (3ct 0st)","0.714"
"9","AJ Finch (AUS)","2016-2021","45","44","25","25","0","0","25","3 (3ct 0st)","0.568"
"10","CJ Jordan (ENG)","2016-2021","47","46","25","25","0","0","25","3 (3ct 0st)","0.543"
"11","V Kohli (INDIA)","2016-2021","50","48","25","25","0","0","25","3 (3ct 0st)","0.520"
"12","TG Southee (NZ)","2017-2021","42","41","25","25","0","0","25","2 (2ct 0st)","0.609"
"13","AT Carey (AUS)","2018-2020","30","29","23","14","9","14","0","3 (1ct 2st)","0.793"
"14","Q de Kock (SA)","2016-2020","22","22","23","19","4","19","0","4 (3ct 1st)","1.045"
"15","Mohammad Nabi (AFG)","2016-2021","37","37","23","23","0","0","23","3 (3ct 0st)","0.621"
"16","Shoaib Malik (ICC/PAK)","2016-2020","41","41","22","22","0","0","22","3 (3ct 0st)","0.536"
"17","GJ Maxwell (AUS)","2016-2021","42","41","21","21","0","0","21","2 (2ct 0st)","0.512"
"18","MJ Santner (NZ)","2016-2021","46","45","21","21","0","0","21","3 (3ct 0st)","0.466"
"19","Mohammed Rizlan (QAT)","2019-2020","22","22","20","13","7","13","0","3 (2ct 1st)","0.909"
"20","HH Pandya (INDIA)","2016-2021","35","34","20","20","0","0","20","2 (2ct 0st)","0.588"
"21","RG Sharma (INDIA)","2016-2021","54","53","20","20","0","0","20","3 (3ct 0st)","0.377"
"22","AC Agar (AUS)","2016-2021","31","31","19","19","0","0","19","2 (2ct 0st)","0.612"
"23","Babar Azam (PAK)","2016-2021","47","47","19","19","0","0","19","2 (2ct 0st)","0.404"
"24","Fakhar Zaman (PAK)","2017-2020","40","40","19","19","0","0","19","2 (2ct 0st)","0.475"
"25","Najibullah Zadran (AFG)","2016-2021","37","37","19","19","0","0","19","2 (2ct 0st)","0.513"
"26","KJ O'Brien (IRE)","2016-2020","45","45","19","19","0","0","19","2 (2ct 0st)","0.422"
"27","CR Brathwaite (WI)","2016-2019","38","38","18","18","0","0","18","2 (2ct 0st)","0.473"
"28","BN Cooper (NL)","2017-2019","28","28","18","18","0","0","18","2 (2ct 0st)","0.642"
"29","MH Cross (SCOT)","2017-2019","24","24","18","12","6","12","0","2 (2ct 0st)","0.750"
"30","CS MacLeod (SCOT)","2017-2019","25","25","18","18","0","0","18","4 (4ct 0st)","0.720"
"31","EJG Morgan (ENG)","2016-2021","44","43","18","18","0","0","18","2 (2ct 0st)","0.418"
"32","KL Rahul (INDIA)","2016-2021","49","47","18","17","1","4","13","2 (2ct 0st)","0.382"
"33","GC Wilson (IRE)","2017-2020","35","35","18","15","3","14","1","3 (3ct 0st)","0.514"
"34","C de Grandhomme (NZ)","2017-2020","32","32","17","17","0","0","17","4 (4ct 0st)","0.531"
"35","Mushfiqur Rahim (BDESH)","2016-2020","32","32","17","10","7","10","0","2 (2ct 0st)","0.531"
"36","GD Phillips (NZ)","2017-2021","22","21","17","15","2","7","8","4 (3ct 1st)","0.809"
"37","N Pooran (WI)","2016-2021","27","26","17","16","1","12","4","3 (3ct 0st)","0.653"
"38","Rashid Khan (AFG/ICC)","2016-2021","38","38","17","17","0","0","17","2 (2ct 0st)","0.447"
"39","Soumya Sarkar (BDESH)","2016-2020","34","34","17","17","0","0","17","2 (2ct 0st)","0.500"
"40","BDH Stevens (JER)","2019-2019","17","17","17","17","0","0","17","3 (3ct 0st)","1.000"
"41","S Dhawan (INDIA)","2016-2021","46","45","16","16","0","0","16","2 (2ct 0st)","0.355"
"42","K Doriga (PNG)","2019-2019","17","17","16","15","1","15","0","5 (5ct 0st)","0.941"
"43","Imad Wasim (PAK)","2016-2020","40","40","16","16","0","0","16","2 (2ct 0st)","0.400"
"44","JW Jenner (JER)","2019-2019","17","17","16","16","0","0","16","4 (4ct 0st)","0.941"
"45","KA Pollard (WI)","2016-2021","34","33","16","16","0","0","16","2 (2ct 0st)","0.484"
"46","TC Bruce (NZ)","2017-2020","17","16","15","15","0","1","14","3 (3ct 0st)","0.937"
"47","S Chandramohan (SGP)","2019-2020","15","15","15","15","0","0","15","3 (3ct 0st)","1.000"
"48","Ghulam Shabber (UAE)","2016-2019","17","17","15","14","1","14","0","2 (2ct 0st)","0.882"
"49","ZE Green (NAM)","2019-2019","16","16","15","10","5","10","0","4 (3ct 1st)","0.937"
"50","Liton Das (BDESH)","2017-2020","26","26","15","15","0","2","13","3 (3ct 0st)","0.576"
"51","Mohammad Shahzad (AFG)","2016-2018","20","20","15","6","9","6","0","3 (2ct 1st)","0.750"
"52","Nizakat Khan (HKG)","2016-2020","24","24","15","15","0","0","15","2 (2ct 0st)","0.625"
"53","NLTC Perera (ICC/SL/World)","2016-2021","35","35","15","15","0","0","15","2 (2ct 0st)","0.428"
"54","SK Raina (INDIA)","2016-2018","20","20","15","15","0","0","15","3 (3ct 0st)","0.750"
"55","D Ramdin (WI)","2016-2019","18","18","15","13","2","13","0","4 (4ct 0st)","0.833"
"56","Shadab Khan (PAK)","2017-2020","46","46","15","15","0","0","15","3 (3ct 0st)","0.326"
"57","SR Thompson (IRE)","2017-2019","24","24","15","15","0","0","15","3 (3ct 0st)","0.625"
"58","KS Williamson (NZ)","2016-2021","36","35","15","15","0","0","15","2 (2ct 0st)","0.428"
"59","LD Chandimal (SL)","2016-2021","18","18","14","9","5","6","3","4 (3ct 1st)","0.777"
"60","L Siaka (PNG)","2017-2019","20","20","14","14","0","0","14","4 (4ct 0st)","0.700"
"61","Sultan Ahmed (UAE)","2017-2020","22","22","14","14","0","0","14","3 (3ct 0st)","0.636"
"62","J Vira (VAN)","2019-2019","14","14","14","10","4","10","0","3 (3ct 0st)","1.000"
"63","Virandeep Singh (MAL)","2019-2020","21","21","14","10","4","4","6","2 (2ct 0st)","0.666"
"64","CAK Walton (WI)","2016-2018","17","17","14","12","2","10","2","3 (3ct 0st)","0.823"
"65","DA Warner (AUS)","2016-2020","24","24","14","14","0","0","14","3 (3ct 0st)","0.583"
"66","A Balbirnie (IRE)","2018-2020","33","33","13","13","0","0","13","2 (2ct 0st)","0.393"
"67","Hamza Tariq (CAN)","2019-2019","12","12","13","9","4","9","0","2 (2ct 0st)","1.083"
"68","Manpreet Singh (SGP)","2019-2020","15","15","13","7","6","7","0","2 (2ct 0st)","0.866"
"69","RR Pant (INDIA)","2017-2021","32","30","13","8","5","6","2","2 (2ct 0st)","0.433"
"70","MP Stoinis (AUS)","2017-2021","27","26","13","13","0","0","13","2 (2ct 0st)","0.500"
"71","Tamoor Sajjad (QAT)","2019-2020","16","16","13","13","0","0","13","2 (2ct 0st)","0.812"
"72","HT Tector (IRE)","2019-2020","20","20","13","13","0","0","13","2 (2ct 0st)","0.650"
"73","JM Bairstow (ENG)","2016-2021","31","30","12","12","0","5","7","2 (2ct 0st)","0.400"
"74","SS Cottrell (WI)","2018-2020","24","23","12","12","0","0","12","2 (2ct 0st)","0.521"
"75","TH David (SGP)","2019-2020","14","14","12","12","0","0","12","4 (4ct 0st)","0.857"
"76","N Dickwella (SL)","2017-2021","23","23","12","11","1","10","1","2 (2ct 0st)","0.521"
"77","KD Karthik (ICC/INDIA)","2017-2019","23","23","12","9","3","6","3","3 (3ct 0st)","0.521"
"78","P Khadka (NEPAL)","2018-2020","22","22","12","12","0","0","12","3 (3ct 0st)","0.545"
"79","H Klaasen (SA)","2018-2021","16","16","12","11","1","6","5","2 (2ct 0st)","0.750"
"80","MA Leask (SCOT)","2017-2019","18","18","12","12","0","0","12","3 (3ct 0st)","0.666"
"81","Mahmudullah (BDESH)","2016-2020","37","37","12","12","0","0","12","2 (2ct 0st)","0.324"
"82","SS McKechnie (HKG)","2019-2020","19","19","12","7","5","7","0","3 (1ct 2st)","0.631"
"83","Mohamed Azzam (Mald)","2019-2020","10","10","12","11","1","11","0","3 (3ct 0st)","1.200"
"84","Mohammad Rizwan (PAK)","2016-2021","20","20","12","8","4","8","0","2 (2ct 0st)","0.600"
"85","C Munro (NZ)","2016-2020","41","40","12","12","0","0","12","2 (2ct 0st)","0.300"
"86","R Powell (WI)","2017-2021","30","29","12","12","0","0","12","2 (2ct 0st)","0.413"
"87","PM Seelaar (NL)","2017-2019","33","32","12","12","0","0","12","2 (2ct 0st)","0.375"
"88","BA Stokes (ENG)","2016-2021","21","21","12","12","0","0","12","3 (3ct 0st)","0.571"
"89","SW Billings (ENG/ICC)","2016-2020","24","23","11","11","0","2","9","2 (2ct 0st)","0.478"
"90","N Davin (NAM)","2019-2019","16","16","11","11","0","0","11","3 (3ct 0st)","0.687"
"91","JSE Dunford (JER)","2019-2019","17","17","11","6","5","6","0","1 (1ct 0st)","0.647"
"92","MG Erasmus (NAM)","2019-2019","16","16","11","11","0","0","11","2 (2ct 0st)","0.687"
"93","AD Hales (ENG)","2016-2019","20","20","11","11","0","0","11","2 (2ct 0st)","0.550"
"94","Iqbal Hussain (QAT)","2019-2020","22","22","11","11","0","0","11","3 (3ct 0st)","0.500"
"95","IA Karim (KENYA)","2019-2019","9","9","11","8","3","8","0","5 (2ct 3st)","1.222"
"96","Khawar Ali (OMAN)","2017-2020","22","22","11","11","0","0","11","2 (2ct 0st)","0.500"
"97","E Lewis (WI)","2016-2021","35","35","11","11","0","0","11","2 (2ct 0st)","0.314"
"98","G Malla (NEPAL)","2018-2020","16","16","11","11","0","0","11","3 (3ct 0st)","0.687"
"99","R Mutumbami (ZIM)","2016-2021","12","12","11","10","1","8","2","4 (4ct 0st)","0.916"
"100","MP O'Dowd (NL)","2017-2019","31","30","11","11","0","0","11","2 (2ct 0st)","0.366"
"101","Sabbir Rahman (BDESH)","2016-2019","21","21","11","11","0","0","11","3 (3ct 0st)","0.523"
"102","SPD Smith (AUS)","2016-2020","19","19","11","11","0","0","11","3 (3ct 0st)","0.578"
"103","IS Sodhi (NZ)","2016-2021","49","48","11","11","0","0","11","1 (1ct 0st)","0.229"
"104","PR Stirling (IRE)","2017-2020","41","41","11","11","0","0","11","1 (1ct 0st)","0.268"
"105","D Weston (GER)","2019-2019","6","6","11","9","2","9","0","4 (3ct 1st)","1.833"
"106","Asif Ali (PAK)","2018-2021","26","26","10","10","0","0","10","1 (1ct 0st)","0.384"
"107","RP Burl (ZIM)","2018-2021","20","20","10","10","0","0","10","2 (2ct 0st)","0.500"
"108","R Escobar (Arg)","2019-2019","5","5","10","7","3","7","0","3 (3ct 0st)","2.000"
"109","SO Hetmyer (WI)","2018-2020","27","27","10","10","0","0","10","2 (2ct 0st)","0.370"
"110","FJ Klaassen (NL)","2018-2019","21","20","10","10","0","0","10","2 (2ct 0st)","0.500"
"111","MDKJ Perera (SL)","2016-2020","25","24","10","6","4","5","1","3 (2ct 1st)","0.416"
"112","KW Richardson (AUS)","2018-2021","23","23","10","10","0","0","10","2 (2ct 0st)","0.434"
"113","Rohan Mustafa (UAE)","2016-2020","27","27","10","10","0","0","10","2 (2ct 0st)","0.370"
"114","JE Root (ENG)","2016-2019","17","17","10","10","0","0","10","2 (2ct 0st)","0.588"
"115","LMP Simmons (WI)","2016-2021","23","23","10","10","0","0","10","2 (2ct 0st)","0.434"
"116","JJ Smit (NAM)","2019-2019","12","12","10","10","0","0","10","3 (3ct 0st)","0.833"
"117","BRM Taylor (ZIM)","2018-2020","17","17","10","9","1","9","0","3 (3ct 0st)","0.588"
"118","LJ Tucker (IRE)","2016-2020","17","17","10","10","0","2","8","2 (2ct 0st)","0.588"
"119","Zaheer Ibrahim (QAT)","2019-2020","20","20","10","10","0","0","10","3 (3ct 0st)","0.500"
"120","Ahmed Raza (UAE)","2016-2020","28","28","9","9","0","0","9","2 (2ct 0st)","0.321"
"121","B Bhandari (NEPAL)","2019-2020","20","20","9","5","4","5","0","2 (1ct 1st)","0.450"
"122","YS Chahal (INDIA)","2016-2021","48","48","9","9","0","0","9","2 (2ct 0st)","0.187"
"123","Faheem Ashraf (PAK)","2017-2021","35","35","9","9","0","0","9","2 (2ct 0st)","0.257"
"124","MD Gunathilaka (SL)","2016-2021","23","22","9","9","0","0","9","3 (3ct 0st)","0.409"
"125","JO Holder (WI)","2017-2021","16","16","9","9","0","0","9","2 (2ct 0st)","0.562"
"126","Janak Prakash (SGP)","2019-2020","15","15","9","9","0","0","9","3 (3ct 0st)","0.600"
"127","Manpreet Singh (ITA)","2019-2019","8","7","9","6","3","6","0","4 (3ct 1st)","1.285"
"128","H Masakadza (ZIM)","2016-2019","19","19","9","9","0","0","9","3 (3ct 0st)","0.473"
"129","TD Paine (AUS/World)","2017-2017","7","7","9","7","2","7","0","3 (3ct 0st)","1.285"
"130","SW Poynter (IRE)","2017-2019","15","15","9","8","1","7","1","2 (2ct 0st)","0.600"
"131","DMW Rawlins (BMUDA)","2019-2019","11","11","9","9","0","0","9","3 (3ct 0st)","0.818"
"132","JA Richardson (AUS)","2017-2021","14","14","9","9","0","0","9","2 (2ct 0st)","0.642"
"133","Samiullah Shinwari (AFG)","2016-2020","24","24","9","9","0","0","9","1 (1ct 0st)","0.375"
"134","SM Sharif (SCOT)","2017-2019","22","22","9","9","0","0","9","2 (2ct 0st)","0.409"
"135","Suraj Kumar (OMAN)","2019-2020","16","16","9","7","2","7","0","2 (2ct 0st)","0.562"
"136","AJ Tye (AUS)","2017-2020","25","24","9","9","0","0","9","2 (2ct 0st)","0.375"
"137","DS Airee (NEPAL)","2018-2020","21","21","8","8","0","0","8","1 (1ct 0st)","0.380"
"138","Asghar Afghan (AFG)","2016-2021","37","37","8","8","0","0","8","2 (2ct 0st)","0.216"
"139","F Behardien (SA)","2016-2018","14","14","8","8","0","0","8","2 (2ct 0st)","0.571"
"140","DG Blampied (JER)","2019-2019","17","17","8","8","0","0","8","2 (2ct 0st)","0.470"
"141","TK Curran (ENG)","2017-2021","28","27","8","8","0","0","8","1 (1ct 0st)","0.296"
"142","GJ Delany (IRE)","2019-2020","23","23","8","8","0","0","8","2 (2ct 0st)","0.347"
"143","S Dube (INDIA)","2019-2020","13","12","8","8","0","0","8","2 (2ct 0st)","0.666"
"144","F du Plessis (SA/World)","2016-2020","19","19","8","8","0","0","8","2 (2ct 0st)","0.421"
"145","JN Frylinck (NAM)","2019-2019","14","14","8","8","0","0","8","2 (2ct 0st)","0.571"
"146","RR Hendricks (SA)","2017-2021","23","23","8","8","0","0","8","2 (2ct 0st)","0.347"
"147","SS Iyer (INDIA)","2017-2021","28","26","8","8","0","0","8","1 (1ct 0st)","0.307"
"148","Karan KC (NEPAL)","2018-2020","23","23","8","8","0","0","8","2 (2ct 0st)","0.347"
"149","Kuldeep Yadav (INDIA)","2017-2020","21","20","8","8","0","0","8","2 (2ct 0st)","0.400"
"150","BR McDermott (AUS)","2018-2019","12","11","8","8","0","0","8","3 (3ct 0st)","0.727"
"151","DJ Mitchell (NZ)","2019-2020","12","12","8","8","0","0","8","2 (2ct 0st)","0.666"
"152","M Mosehle (SA)","2017-2017","7","7","8","6","2","6","0","3 (2ct 1st)","1.142"
"153","Muhammad Usman (UAE)","2016-2020","28","28","8","8","0","0","8","1 (1ct 0st)","0.285"
"154","S Muniandy (MAL)","2019-2020","24","23","8","8","0","0","8","3 (3ct 0st)","0.347"
"155","HG Munsey (SCOT)","2017-2019","25","25","8","8","0","0","8","2 (2ct 0st)","0.320"
"156","Mustafizur Rahman (BDESH)","2016-2020","31","31","8","8","0","0","8","3 (3ct 0st)","0.258"
"157","Nouman Sarwar (QAT)","2019-2019","14","14","8","8","0","0","8","2 (2ct 0st)","0.571"
"158","MK Pandey (INDIA)","2016-2020","37","37","8","8","0","0","8","2 (2ct 0st)","0.216"
"159","Rameez Shahzad (UAE)","2016-2019","22","22","8","8","0","0","8","2 (2ct 0st)","0.363"
"160","WB Rankin (IRE)","2017-2020","28","28","8","8","0","0","8","1 (1ct 0st)","0.285"
"161","AU Rashid (ENG)","2016-2021","43","42","8","8","0","0","8","2 (2ct 0st)","0.190"
"162","Ravinderpal Singh (CAN)","2019-2019","12","12","8","8","0","0","8","2 (2ct 0st)","0.666"
"163","KD Shah (HKG)","2019-2020","20","20","8","8","0","0","8","3 (3ct 0st)","0.400"
"164","T Shamsi (SA)","2017-2021","28","28","8","8","0","0","8","2 (2ct 0st)","0.285"
"165","MD Shanaka (SL)","2016-2020","32","31","8","8","0","0","8","2 (2ct 0st)","0.258"
"166","DJM Short (AUS)","2018-2020","23","22","8","8","0","0","8","2 (2ct 0st)","0.363"
"167","Usman Patel (KUW)","2020-2020","5","5","8","6","2","6","0","4 (4ct 0st)","1.600"
"168","A Vala (PNG)","2017-2019","20","20","8","8","0","0","8","1 (1ct 0st)","0.400"
"169","RE van der Merwe (NL)","2017-2019","22","22","8","8","0","0","8","2 (2ct 0st)","0.363"
"170","Washington Sundar (INDIA)","2017-2021","30","28","8","8","0","0","8","1 (1ct 0st)","0.285"
"171","DJ Willey (ENG)","2016-2019","22","22","8","8","0","0","8","2 (2ct 0st)","0.363"
"172","KOK Williams (WI)","2016-2020","26","26","8","8","0","0","8","1 (1ct 0st)","0.307"
"173","Aamir Kaleem (OMAN)","2019-2020","17","17","7","7","0","0","7","2 (2ct 0st)","0.411"
"174","Aqib Ilyas (OMAN)","2017-2019","17","17","7","7","0","0","7","2 (2ct 0st)","0.411"
"175","TA Boult (NZ)","2017-2021","23","23","7","7","0","0","7","3 (3ct 0st)","0.304"
"176","DJ Bravo (WI)","2016-2021","18","18","7","7","0","0","7","2 (2ct 0st)","0.388"
"177","NM Coulter-Nile (AUS)","2016-2019","15","14","7","7","0","0","7","2 (2ct 0st)","0.500"
"178","LB Ferbrache (GUE)","2019-2020","10","10","7","7","0","0","7","2 (2ct 0st)","0.700"
"179","Fiaz Ahmed (BHR)","2019-2020","8","8","7","7","0","0","7","2 (2ct 0st)","0.875"
"180","S Gajjar (CZK-R)","2020-2020","3","3","7","4","3","3","1","3 (2ct 1st)","2.333"
"181","Hasan Ali (PAK)","2016-2021","31","31","7","7","0","0","7","1 (1ct 0st)","0.225"
"182","AW Hawkins-Kay (JER)","2019-2019","16","16","7","7","0","0","7","2 (2ct 0st)","0.437"
"183","Hilal Ahmad (CZK-R)","2019-2020","10","10","7","7","0","6","1","3 (3ct 0st)","0.700"
"184","DJ Malan (ENG)","2017-2021","23","22","7","7","0","0","7","2 (2ct 0st)","0.318"
"185","J Mees (LUX)","2019-2020","8","8","7","6","1","4","2","2 (2ct 0st)","0.875"
"186","Mehidy Hasan Miraz (BDESH)","2017-2018","13","13","7","7","0","0","7","2 (2ct 0st)","0.538"
"187","Mohammad Nadeem (OMAN)","2017-2020","23","23","7","7","0","0","7","3 (3ct 0st)","0.304"
"188","AK Mohan (Fin)","2019-2019","5","5","7","5","2","3","2","3 (2ct 1st)","1.400"
"189","K Motlhanka (Botsw)","2019-2019","7","7","7","3","4","3","0","4 (2ct 2st)","1.000"
"190","KH Pandya (INDIA)","2018-2019","18","18","7","7","0","0","7","2 (2ct 0st)","0.388"
"191","AL Phehlukwayo (SA)","2017-2021","30","30","7","7","0","0","7","2 (2ct 0st)","0.233"
"192","Saber Zakhil (Belg)","2019-2020","7","7","7","7","0","0","7","2 (2ct 0st)","1.000"
"193","P Sarraf (NEPAL)","2019-2020","12","12","7","7","0","0","7","4 (4ct 0st)","0.583"
"194","Shaiman Anwar (UAE)","2016-2019","14","14","7","7","0","0","7","2 (2ct 0st)","0.500"
"195","Simi Singh (IRE)","2018-2020","24","24","7","7","0","0","7","2 (2ct 0st)","0.291"
"196","Sompal Kami (NEPAL)","2018-2019","17","17","7","7","0","0","7","2 (2ct 0st)","0.411"
"197","MA Starc (AUS)","2016-2020","15","15","7","7","0","0","7","2 (2ct 0st)","0.466"
"198","R Tari (VAN)","2019-2019","14","14","7","7","0","0","7","2 (2ct 0st)","0.500"
"199","TP Ura (PNG)","2017-2019","20","20","7","7","0","0","7","2 (2ct 0st)","0.350"
"200","T van der Gugten (NL)","2017-2019","17","17","7","7","0","0","7","2 (2ct 0st)","0.411"
"201","PA van Meekeren (NL)","2017-2019","26","25","7","7","0","0","7","2 (2ct 0st)","0.280"
"202","SC Williams (ZIM)","2018-2021","19","19","7","7","0","0","7","2 (2ct 0st)","0.368"
"203","Yasir Ali (ESP)","2019-2020","11","11","7","7","0","0","7","2 (2ct 0st)","0.636"
"204","A Zampa (AUS)","2016-2021","39","38","7","7","0","0","7","2 (2ct 0st)","0.184"
"205","Zeeshan Maqsood (OMAN)","2017-2020","19","19","7","7","0","0","7","2 (2ct 0st)","0.368"
"206","Aarif Sheikh (NEPAL)","2018-2020","14","14","6","6","0","0","6","1 (1ct 0st)","0.428"
"207","FA Allen (WI)","2018-2021","19","18","6","6","0","0","6","2 (2ct 0st)","0.333"
"208","CJ Anderson (NZ)","2016-2018","10","10","6","6","0","0","6","2 (2ct 0st)","0.600"
"209","SE Aquilina (MLT)","2019-2020","7","7","6","2","4","2","0","2 (0ct 2st)","0.857"
"210","Awais Ahmed (ESP)","2019-2020","11","11","6","5","1","5","0","1 (1ct 0st)","0.545"
"211","T Banton (ENG)","2019-2020","9","8","6","6","0","0","6","2 (2ct 0st)","0.750"
"212","S Bau (PNG)","2017-2019","20","20","6","6","0","0","6","3 (3ct 0st)","0.300"
"213","T Bavuma (SA)","2019-2020","8","8","6","6","0","0","6","3 (3ct 0st)","0.750"
"214","JJ Bumrah (INDIA)","2016-2020","38","37","6","6","0","0","6","2 (2ct 0st)","0.162"
"215","E Chigumbura (ZIM)","2016-2020","13","13","6","6","0","0","6","2 (2ct 0st)","0.461"
"216","KJ Coetzer (SCOT)","2017-2019","23","23","6","6","0","0","6","1 (1ct 0st)","0.260"
"217","FA Cossa (Moz)","2019-2019","6","5","6","6","0","0","6","3 (3ct 0st)","1.200"
"218","PJ Cummins (AUS)","2017-2020","15","15","6","6","0","0","6","1 (1ct 0st)","0.400"
"219","A Dananjaya (SL)","2017-2021","20","20","6","6","0","0","6","1 (1ct 0st)","0.300"
"220","AB de Villiers (SA)","2016-2017","11","11","6","6","0","0","6","2 (2ct 0st)","0.545"
"221","Ehsan Khan (HKG)","2016-2020","23","23","6","6","0","0","6","1 (1ct 0st)","0.260"
"222","ADS Fletcher (WI)","2016-2020","21","20","6","6","0","2","4","1 (1ct 0st)","0.300"
"223","Gulbadin Naib (AFG)","2016-2020","22","22","6","6","0","0","6","1 (1ct 0st)","0.272"
"224","SD Hope (WI)","2017-2019","13","13","6","6","0","6","0","2 (2ct 0st)","0.461"
"225","Imran Ismail (Moz)","2019-2019","7","6","6","6","0","5","1","2 (2ct 0st)","1.000"
"226","Jatinder Singh (OMAN)","2019-2020","17","17","6","6","0","0","6","1 (1ct 0st)","0.352"
"227","Kamran Khan (QAT)","2019-2020","21","21","6","6","0","0","6","2 (2ct 0st)","0.285"
"228","Karim Janat (AFG)","2016-2021","25","25","6","6","0","0","6","2 (2ct 0st)","0.240"
"229","EB Knowles (CZK-R)","2019-2020","11","11","6","6","0","2","4","4 (4ct 0st)","0.545"
"230","ND Laegsgaard (DEN)","2019-2019","9","7","6","6","0","0","6","3 (3ct 0st)","0.857"
"231","MR Marsh (AUS)","2016-2021","13","13","6","6","0","0","6","2 (2ct 0st)","0.461"
"232","PK Matautaava (VAN)","2019-2019","10","10","6","6","0","0","6","3 (3ct 0st)","0.600"
"233","BKG Mendis (SL)","2016-2020","26","26","6","6","0","0","6","1 (1ct 0st)","0.230"
"234","Mohammad Nawaz (3) (PAK)","2016-2021","17","17","6","6","0","0","6","1 (1ct 0st)","0.352"
"235","Mosaddek Hossain (BDESH)","2017-2019","13","13","6","6","0","0","6","2 (2ct 0st)","0.461"
"236","Muhammad Tanveer (QAT)","2019-2020","22","22","6","6","0","0","6","2 (2ct 0st)","0.272"
"237","C Munoz-Mills (ESP)","2019-2020","11","11","6","6","0","0","6","2 (2ct 0st)","0.545"
"238","CO Obuya (KENYA)","2019-2019","9","9","6","6","0","0","6","2 (2ct 0st)","0.666"
"239","R Panchal (ESP)","2019-2020","11","11","6","6","0","0","6","2 (2ct 0st)","0.545"
"240","HH Patel (MWI)","2019-2019","7","7","6","6","0","0","6","2 (2ct 0st)","0.857"
"241","RR Patel (KENYA)","2019-2019","8","8","6","6","0","0","6","2 (2ct 0st)","0.750"
"242","CW Perchard (JER)","2019-2019","15","15","6","6","0","0","6","1 (1ct 0st)","0.400"
"243","BBJL Perera (ITA)","2019-2019","8","7","6","6","0","0","6","3 (3ct 0st)","0.857"
"244","Aminuddin Ramly (MAL)","2019-2020","19","18","6","6","0","0","6","2 (2ct 0st)","0.333"
"245","Rehman Abdul (ITA)","2019-2019","7","6","6","6","0","0","6","2 (2ct 0st)","1.000"
"246","S Samarawickrama (SL)","2017-2019","7","7","6","4","2","3","1","2 (1ct 1st)","0.857"
"247","PADLR Sandakan (SL)","2017-2021","19","19","6","6","0","0","6","2 (2ct 0st)","0.315"
"248","Shafraz Jaleel (Mald)","2019-2019","4","4","6","4","2","4","0","3 (3ct 0st)","1.500"
"249","HAM Shah (DEN)","2019-2019","9","7","6","6","0","0","6","3 (3ct 0st)","0.857"
"250","Shahid Wasif (HKG)","2016-2020","18","18","6","6","0","0","6","2 (2ct 0st)","0.333"
"251","Syed Aziz (MAL)","2019-2020","23","22","6","6","0","0","6","1 (1ct 0st)","0.272"
"252","Tamim Iqbal (BDESH/ICC/World)","2016-2020","28","28","6","6","0","0","6","2 (2ct 0st)","0.214"
"253","Usman Ghani (AFG)","2016-2021","13","13","6","6","0","0","6","2 (2ct 0st)","0.461"
"254","MS Wade (AUS)","2016-2021","13","13","6","6","0","6","0","2 (2ct 0st)","0.461"
"255","CA Young (IRE)","2016-2020","22","22","6","6","0","0","6","2 (2ct 0st)","0.272"
"256","F Achelam (UGA)","2019-2020","4","4","5","4","1","4","0","4 (3ct 1st)","1.250"
"257","KK Ahuja (Mex)","2019-2019","8","8","5","2","3","1","1","2 (0ct 2st)","0.625"
"258","PS Airee (NEPAL)","2019-2019","4","4","5","4","1","3","1","2 (2ct 0st)","1.250"
"259","MM Ali (ENG)","2016-2020","21","20","5","5","0","0","5","2 (2ct 0st)","0.250"
"260","Ariful Haque (BDESH)","2018-2018","9","9","5","5","0","0","5","1 (1ct 0st)","0.555"
"261","Asad Mohammad (GER)","2019-2020","10","10","5","5","0","0","5","1 (1ct 0st)","0.500"
"262","MNM Aslam (KUW)","2019-2020","11","11","5","5","0","0","5","1 (1ct 0st)","0.454"
"263","SJ Baard (NAM)","2019-2019","13","13","5","5","0","0","5","2 (2ct 0st)","0.384"
"264","J Barker (LUX)","2019-2020","7","7","5","5","0","0","5","2 (2ct 0st)","0.714"
"265","O Bascome (BMUDA)","2019-2019","11","11","5","4","1","2","2","2 (2ct 0st)","0.454"
"266","Bilal Tahir (KUW)","2019-2020","7","7","5","5","0","0","5","1 (1ct 0st)","0.714"
"267","A Bohara (NEPAL)","2019-2020","20","20","5","5","0","0","5","1 (1ct 0st)","0.250"
"268","S Browne (LUX)","2020-2020","4","4","5","5","0","0","5","2 (2ct 0st)","1.250"
"269","MS Chapman (NZ)","2018-2021","8","8","5","5","0","0","5","2 (2ct 0st)","0.625"
"270","PKD Chase (IRE)","2018-2019","12","12","5","5","0","0","5","2 (2ct 0st)","0.416"
"271","DP Conway (NZ)","2020-2021","11","11","5","5","0","0","5","2 (2ct 0st)","0.454"
"272","K Dasan (BUL)","2019-2020","10","9","5","3","2","2","1","2 (1ct 1st)","0.555"
"273","PWH de Silva (SL)","2019-2021","16","15","5","5","0","0","5","1 (1ct 0st)","0.333"
"274","NS Dhaliwal (CAN)","2019-2019","12","12","5","5","0","0","5","1 (1ct 0st)","0.416"
"275","AC Douglas (BMUDA)","2019-2019","10","10","5","5","0","0","5","3 (3ct 0st)","0.500"
"276","Fahad Ali ()","2019-2019","3","3","5","4","1","2","2","3 (2ct 1st)","1.666"
"277","Faisal Javed (QAT)","2019-2019","15","15","5","5","0","0","5","1 (1ct 0st)","0.333"
"278","JP Faulkner (AUS)","2016-2017","9","9","5","5","0","0","5","2 (2ct 0st)","0.555"
"279","Fitri Sham (MAL)","2019-2020","22","21","5","5","0","0","5","1 (1ct 0st)","0.238"
"280","NA Greenwood (JER)","2019-2019","8","8","5","5","0","0","5","3 (3ct 0st)","0.625"
"281","DAS Gunaratne (SL)","2017-2017","11","11","5","5","0","0","5","2 (2ct 0st)","0.454"
"282","S Hallett (Peru)","2019-2019","4","4","5","4","1","4","0","3 (3ct 0st)","1.250"
"283","Hussain Talat (PAK)","2018-2021","18","18","5","5","0","0","5","3 (3ct 0st)","0.277"
"284","Ibrahim Hassan (Mald)","2019-2020","14","14","5","5","0","0","5","2 (2ct 0st)","0.357"
"285","Imran Haider (ROM)","2019-2020","3","3","5","3","2","3","0","3 (2ct 1st)","1.666"
"286","RA Jadeja (INDIA)","2016-2020","17","17","5","5","0","0","5","2 (2ct 0st)","0.294"
"287","Jagjit Singh (Peru)","2019-2019","4","4","5","5","0","0","5","3 (3ct 0st)","1.250"
"288","S Jamil (Belg)","2019-2020","6","6","5","5","0","4","1","2 (2ct 0st)","0.833"
"289","KM Jarvis (ZIM)","2018-2019","13","13","5","5","0","0","5","1 (1ct 0st)","0.384"
"290","Junaid Sheikh (NOR)","2019-2019","5","5","5","5","0","0","5","2 (2ct 0st)","1.000"
"291","D Kansonkho (MWI)","2019-2019","7","7","5","5","0","0","5","2 (2ct 0st)","0.714"
"292","JP Kotze (NAM)","2019-2019","12","12","5","5","0","0","5","2 (2ct 0st)","0.416"
"293","SC Kuggeleijn (NZ)","2019-2020","16","16","5","5","0","0","5","2 (2ct 0st)","0.312"
"294","NR Kumar (CAN)","2019-2019","12","12","5","5","0","0","5","2 (2ct 0st)","0.416"
"295","JS Malhotra (USA)","2019-2019","6","6","5","2","3","2","0","2 (0ct 2st)","0.833"
"296","SL Malinga (SL)","2017-2020","22","21","5","5","0","0","5","2 (2ct 0st)","0.238"
"297","A Mansale (VAN)","2019-2019","14","14","5","5","0","0","5","2 (2ct 0st)","0.357"
"298","EJB Miles (JER)","2019-2019","14","14","5","5","0","0","5","2 (2ct 0st)","0.357"
"299","Mohamed Rishwan (Mald)","2019-2020","14","14","5","5","0","0","5","2 (2ct 0st)","0.357"
"300","Mohammad Hafeez (PAK)","2016-2020","23","23","5","5","0","0","5","2 (2ct 0st)","0.217"
"301","Mohammed Nadeem (QAT)","2019-2020","22","22","5","5","0","0","5","2 (2ct 0st)","0.227"
"302","Murid Ekrami (Belg)","2019-2020","7","7","5","5","0","0","5","2 (2ct 0st)","0.714"
"303","JDS Neesham (NZ)","2017-2021","16","16","5","5","0","0","5","2 (2ct 0st)","0.312"
"304","R Nehonde (Botsw)","2019-2019","7","7","5","5","0","0","5","3 (3ct 0st)","0.714"
"305","OE Newey (GUE)","2019-2019","7","7","5","4","1","4","0","2 (2ct 0st)","0.714"
"306","AR Nurse (WI)","2017-2019","9","9","5","5","0","0","5","2 (2ct 0st)","0.555"
"307","CN Onwuzulike (NGA)","2019-2019","9","9","5","5","0","0","5","3 (3ct 0st)","0.555"
"308","MD Patel (USA)","2019-2019","8","8","5","3","2","1","2","2 (1ct 1st)","0.625"
"309","NK Patel (USA)","2019-2019","4","4","5","5","0","0","5","2 (2ct 0st)","1.250"
"310","Pavandeep Singh (MAL)","2019-2020","19","19","5","5","0","0","5","2 (2ct 0st)","0.263"
"311","LE Plunkett (ENG)","2016-2019","19","19","5","5","0","0","5","1 (1ct 0st)","0.263"
"312","Rahmanullah Gurbaz (AFG)","2019-2021","11","11","5","4","1","4","0","2 (1ct 1st)","0.454"
"313","J Rasu (VAN)","2019-2019","13","13","5","5","0","0","5","1 (1ct 0st)","0.384"
"314","D Ravu (PNG)","2019-2019","17","17","5","5","0","0","5","1 (1ct 0st)","0.294"
"315","R Rohan (SGP)","2019-2020","13","13","5","5","0","0","5","1 (1ct 0st)","0.384"
"316","L Ronchi (ICC/NZ)","2016-2018","8","8","5","2","3","2","0","2 (1ct 1st)","0.625"
"317","Sami Sohail (MWI)","2019-2019","7","7","5","5","0","0","5","2 (2ct 0st)","0.714"
"318","Sandeep Goud (OMAN)","2019-2020","15","15","5","5","0","0","5","2 (2ct 0st)","0.333"
"319","Shafiqullah (AFG)","2016-2019","18","18","5","3","2","1","2","2 (1ct 1st)","0.277"
"320","Shafiq Sharif (MAL)","2019-2019","10","9","5","2","3","2","0","2 (2ct 0st)","0.555"
"321","Shakib Al Hasan (BDESH)","2016-2019","25","25","5","5","0","0","5","2 (2ct 0st)","0.200"
"322","Shiraz Khan (KUW)","2019-2020","11","11","5","5","0","0","5","1 (1ct 0st)","0.454"
"323","TB Sole (SCOT)","2019-2019","9","9","5","5","0","0","5","1 (1ct 0st)","0.555"
"324","LRPL Taylor (NZ)","2016-2020","33","33","5","5","0","0","5","1 (1ct 0st)","0.151"
"325","SR Taylor (USA)","2019-2019","8","8","5","5","0","0","5","2 (2ct 0st)","0.625"
"326","AJ Turner (AUS)","2017-2019","11","11","5","5","0","0","5","1 (1ct 0st)","0.454"
"327","Umar Akmal (PAK)","2016-2019","8","8","5","5","0","0","5","3 (3ct 0st)","0.625"
"328","N Vanua (PNG)","2017-2019","19","19","5","5","0","0","5","2 (2ct 0st)","0.263"
"329","C Viljoen (NAM)","2019-2019","12","12","5","5","0","0","5","1 (1ct 0st)","0.416"
"330","JM Vince (ENG)","2016-2019","9","9","5","5","0","0","5","2 (2ct 0st)","0.555"
"331","B Ward (JER)","2019-2019","13","13","5","5","0","0","5","1 (1ct 0st)","0.384"
"332","MRJ Watt (SCOT)","2017-2019","21","21","5","5","0","0","5","1 (1ct 0st)","0.238"
"333","Sarfraz Butt (Saudi)","2020-2020","3","3","5","1","4","1","0","3 (0ct 3st)","1.666"
"334","Abdul-Shakoor Rahimzei (GER)","2019-2020","9","9","4","4","0","0","4","2 (2ct 0st)","0.444"
"335","CN Ackermann (NL)","2019-2019","11","11","4","4","0","0","4","1 (1ct 0st)","0.363"
"336","Adnan Idrees (KUW)","2019-2019","6","6","4","4","0","0","4","1 (1ct 0st)","0.666"
"337","Ahmed Faiz (MAL)","2019-2020","18","17","4","4","0","0","4","2 (2ct 0st)","0.235"
"338","Aizaz Khan (HKG)","2016-2020","20","20","4","4","0","0","4","1 (1ct 0st)","0.200"
"339","Amjad Mahboob (SGP)","2019-2020","14","14","4","4","0","0","4","1 (1ct 0st)","0.285"
"340","HM Amla (SA/World)","2016-2018","11","11","4","4","0","0","4","1 (1ct 0st)","0.363"
"341","JC Archer (ENG)","2019-2021","11","11","4","4","0","0","4","2 (2ct 0st)","0.363"
"342","Awais Malik (QAT)","2019-2020","18","18","4","4","0","0","4","2 (2ct 0st)","0.222"
"343","MA Baig (MWI)","2019-2019","7","7","4","4","0","0","4","3 (3ct 0st)","0.571"
"344","B Banerjee (Mex)","2019-2019","6","6","4","4","0","3","1","1 (1ct 0st)","0.666"
"345","Basil Hameed (UAE)","2020-2020","4","4","4","4","0","0","4","2 (2ct 0st)","1.000"
"346","JP Behrendorff (AUS)","2017-2019","7","6","4","4","0","0","4","3 (3ct 0st)","0.666"
"347","RD Berrington (SCOT)","2017-2019","25","25","4","4","0","0","4","1 (1ct 0st)","0.160"
"348","TS Bharaj (DEN)","2019-2019","9","7","4","4","0","0","4","3 (3ct 0st)","0.571"
"349","Meet Bhavsar (KUW)","2019-2019","9","9","4","4","0","4","0","3 (3ct 0st)","0.444"
"350","MP Biddappa (PHI)","2019-2019","4","4","4","3","1","3","0","2 (2ct 0st)","1.000"
"351","PRP Boissevain (NL)","2019-2019","4","4","4","4","0","0","4","2 (2ct 0st)","1.000"
"352","DE Budge (SCOT)","2018-2018","6","6","4","4","0","0","4","1 (1ct 0st)","0.666"
"353","RW Chakabva (ZIM)","2019-2019","7","7","4","4","0","0","4","1 (1ct 0st)","0.571"
"354","JW Chilia (VAN)","2019-2019","14","14","4","4","0","0","4","2 (2ct 0st)","0.285"
"355","K Christie (HKG)","2019-2019","11","11","4","4","0","0","4","1 (1ct 0st)","0.363"
"356","DDP D'Silva (UAE)","2019-2019","10","10","4","4","0","0","4","1 (1ct 0st)","0.400"
"357","KC D'Souza (BUL)","2020-2020","7","6","4","4","0","0","4","1 (1ct 0st)","0.666"
"358","DAP Darrell (BMUDA)","2019-2019","11","11","4","4","0","0","4","2 (2ct 0st)","0.363"
"359","JH Davey (SCOT)","2017-2019","10","10","4","4","0","0","4","1 (1ct 0st)","0.400"
"360","DM de Silva (SL)","2016-2020","14","13","4","4","0","0","4","1 (1ct 0st)","0.307"
"361","CR Ervine (ZIM)","2019-2020","9","9","4","4","0","0","4","3 (3ct 0st)","0.444"
"362","LH Ferguson (NZ)","2017-2020","11","11","4","4","0","0","4","2 (2ct 0st)","0.363"
"363","WIA Fernando (SL)","2019-2020","15","14","4","4","0","0","4","2 (2ct 0st)","0.285"
"364","O Fournier (CRC)","2019-2019","2","2","4","4","0","0","4","2 (2ct 0st)","2.000"
"365","PF Gallagher (Fin)","2019-2019","3","3","4","4","0","0","4","2 (2ct 0st)","1.333"
"366","DM Gondaria (KENYA)","2019-2019","9","9","4","4","0","0","4","1 (1ct 0st)","0.444"
"367","K Gupta (Chile)","2019-2019","4","4","4","3","1","3","0","3 (2ct 1st)","1.000"
"368","OD Hald (DEN)","2019-2019","9","7","4","4","0","0","4","2 (2ct 0st)","0.571"
"369","Hamza Tahir (SCOT)","2018-2019","11","11","4","4","0","0","4","1 (1ct 0st)","0.363"
"370","Haris Rauf (PAK)","2020-2021","13","13","4","4","0","0","4","1 (1ct 0st)","0.307"
"371","TM Head (AUS)","2016-2018","14","14","4","4","0","0","4","1 (1ct 0st)","0.285"
"372","R Hekure (PNG)","2019-2019","8","8","4","4","0","0","4","2 (2ct 0st)","0.500"
"373","DR Hooper (GUE)","2019-2019","9","9","4","4","0","0","4","2 (2ct 0st)","0.444"
"374","Ibrahim Rizan (Mald)","2019-2020","8","8","4","4","0","0","4","3 (3ct 0st)","0.500"
"375","Iftikhar Ahmed (PAK)","2019-2021","12","12","4","4","0","0","4","1 (1ct 0st)","0.333"
"376","Imran Tahir (SA/World)","2016-2019","15","15","4","4","0","0","4","2 (2ct 0st)","0.266"
"377","G Kansonkho (MWI)","2019-2019","6","6","4","4","0","0","4","2 (2ct 0st)","0.666"
"378","CK Kapugedera (SL)","2016-2017","10","10","4","4","0","0","4","3 (3ct 0st)","0.400"
"379","Khizar Hayat (MAL)","2020-2020","9","9","4","4","0","0","4","2 (2ct 0st)","0.444"
"380","BA King (WI)","2019-2020","11","10","4","4","0","0","4","1 (1ct 0st)","0.400"
"381","Kuldeep Lal (ESP)","2019-2020","10","10","4","4","0","0","4","2 (2ct 0st)","0.400"
"382","B Kumar (INDIA)","2016-2021","33","32","4","4","0","0","4","1 (1ct 0st)","0.125"
"383","MSS Mandy (Chile)","2019-2019","4","4","4","4","0","0","4","1 (1ct 0st)","1.000"
"384","WP Masakadza (ZIM)","2018-2020","6","6","4","4","0","0","4","2 (2ct 0st)","0.666"
"385","Md Nurul Huda (Fin)","2019-2019","5","5","4","4","0","0","4","2 (2ct 0st)","0.800"
"386","AS Mehmi ()","2019-2019","3","3","4","4","0","0","4","2 (2ct 0st)","1.333"
"387","Mohamed Arief (MAL)","2019-2020","12","12","4","4","0","0","4","2 (2ct 0st)","0.333"
"388","Mohammad Boota (UAE)","2019-2019","16","16","4","3","1","2","1","2 (1ct 1st)","0.250"
"389","Mohammad Naim (BDESH)","2019-2020","6","6","4","4","0","0","4","2 (2ct 0st)","0.666"
"390","PJ Moor (ZIM)","2016-2019","15","15","4","4","0","2","2","1 (1ct 0st)","0.266"
"391","Muhammad Awais ()","2019-2019","3","3","4","3","1","3","0","3 (2ct 1st)","1.333"
"392","Mujeeb Ur Rahman (AFG)","2018-2020","19","19","4","4","0","0","4","1 (1ct 0st)","0.210"
"393","GRD Munasinghe (ITA)","2019-2019","8","7","4","4","0","0","4","1 (1ct 0st)","0.571"
"394","SP Narine (WI)","2016-2019","17","17","4","4","0","0","4","2 (2ct 0st)","0.235"
"395","Nazril Rahman (MAL)","2019-2020","11","11","4","4","0","0","4","2 (2ct 0st)","0.363"
"396","A Neill (SCOT)","2019-2019","5","5","4","4","0","0","4","2 (2ct 0st)","0.800"
"397","SN Netravalkar (USA)","2019-2019","8","8","4","4","0","0","4","1 (1ct 0st)","0.500"
"398","N Nipiko (VAN)","2019-2019","14","14","4","4","0","0","4","1 (1ct 0st)","0.285"
"399","NM Odhiambo (KENYA)","2019-2019","8","8","4","4","0","0","4","2 (2ct 0st)","0.500"
"400","RK Paudel (NEPAL)","2019-2019","11","11","4","4","0","0","4","2 (2ct 0st)","0.363"
"401","N Pokana (PNG)","2019-2019","16","16","4","4","0","0","4","2 (2ct 0st)","0.250"
"402","MJ Richardson (GER)","2019-2020","5","5","4","1","3","1","0","2 (1ct 1st)","0.800"
"403","JJ Roy (ENG)","2016-2021","33","33","4","4","0","0","4","1 (1ct 0st)","0.121"
"404","AD Russell (WI)","2016-2020","13","13","4","4","0","0","4","1 (1ct 0st)","0.307"
"405","MN Samuels (WI)","2016-2018","26","26","4","4","0","0","4","1 (1ct 0st)","0.153"
"406","R Satheesan (ROM)","2019-2020","8","8","4","4","0","0","4","2 (2ct 0st)","0.500"
"407","D Sheeli (KUW)","2019-2020","5","5","4","4","0","0","4","3 (3ct 0st)","0.800"
"408","B Shikongo (NAM)","2019-2019","11","11","4","4","0","0","4","1 (1ct 0st)","0.363"
"409","Simandeep Singh (HKG)","2019-2019","7","7","4","4","0","0","4","2 (2ct 0st)","0.571"
"410","Sultan Ahmed (OMAN)","2017-2017","4","4","4","4","0","4","0","2 (2ct 0st)","1.000"
"411","MJ Swepson (AUS)","2018-2020","4","4","4","4","0","0","4","2 (2ct 0st)","1.000"
"412","SN Thakur (INDIA)","2018-2021","21","19","4","4","0","0","4","1 (1ct 0st)","0.210"
"413","C Tommy (VAN)","2019-2019","12","12","4","4","0","0","4","1 (1ct 0st)","0.333"
"414","HE van der Dussen (SA)","2018-2020","18","18","4","4","0","0","4","2 (2ct 0st)","0.222"
"415","S Vashisht (ROM)","2019-2020","6","6","4","4","0","0","4","1 (1ct 0st)","0.666"
"416","C Waiswa (UGA)","2019-2020","7","7","4","4","0","0","4","1 (1ct 0st)","0.571"
"417","Zahoor Khan (UAE)","2017-2020","22","22","4","4","0","0","4","1 (1ct 0st)","0.181"
"418","Abdul Shakoor (ROM)","2019-2020","4","4","3","1","2","1","0","2 (1ct 1st)","0.750"
"419","Abdul Waheed (Saudi)","2020-2020","3","3","3","3","0","0","3","2 (2ct 0st)","1.000"
"420","Abrar Bilal (Aut)","2019-2019","4","4","3","0","3","0","0","1 (0ct 1st)","0.750"
"421","MR Adair (IRE)","2019-2020","18","18","3","3","0","0","3","1 (1ct 0st)","0.166"
"422","S Adedeji (NGA)","2019-2019","6","6","3","3","0","0","3","1 (1ct 0st)","0.500"
"423","Afif Hossain (BDESH)","2018-2020","12","12","3","3","0","0","3","1 (1ct 0st)","0.250"
"424","Aftab Alam (AFG)","2016-2018","6","6","3","3","0","0","3","2 (2ct 0st)","0.500"
"425","KK Ahmed (INDIA)","2018-2019","14","14","3","3","0","0","3","1 (1ct 0st)","0.214"
"426","Ainool Haqqiem (MAL)","2019-2019","4","4","3","1","2","1","0","2 (0ct 2st)","0.750"
"427","TP Allen (USA)","2019-2019","5","5","3","3","0","0","3","1 (1ct 0st)","0.600"
"428","CJA Amini (PNG)","2019-2019","17","17","3","3","0","0","3","1 (1ct 0st)","0.176"
"429","Amir Mangal (GER)","2019-2020","10","10","3","3","0","0","3","2 (2ct 0st)","0.300"
"430","Anowarul Islam (THAI)","2019-2019","4","4","3","3","0","0","3","2 (2ct 0st)","0.750"
"431","Ansh Tandon (UAE)","2020-2020","1","1","3","3","0","0","3","3 (3ct 0st)","3.000"
"432","V Aravind (UAE)","2020-2020","5","5","3","3","0","3","0","3 (3ct 0st)","0.600"
"433","P Arrighi (Arg)","2019-2019","5","5","3","3","0","0","3","2 (2ct 0st)","0.600"
"434","A Ashokan (CZK-R)","2019-2020","6","6","3","3","0","0","3","1 (1ct 0st)","0.500"
"435","JJ Atkinson (HKG)","2020-2020","4","4","3","3","0","0","3","2 (2ct 0st)","0.750"
"436","AJ Ayannaike (NGA)","2019-2019","3","3","3","2","1","2","0","3 (2ct 1st)","1.000"
"437","F Baaleri (Ghana)","2019-2019","4","4","3","3","0","1","2","2 (2ct 0st)","0.750"
"438","Babar Ali (BHR)","2019-2019","3","3","3","3","0","0","3","1 (1ct 0st)","1.000"
"439","V Balakrishnan (Botsw)","2019-2019","3","3","3","3","0","0","3","3 (3ct 0st)","1.000"
"440","OGL Bascome (BMUDA)","2019-2019","11","11","3","3","0","0","3","1 (1ct 0st)","0.272"
"441","V Baskaran (SGP)","2019-2020","13","13","3","3","0","0","3","1 (1ct 0st)","0.230"
"442","SJ Benn (WI)","2016-2016","5","5","3","3","0","0","3","1 (1ct 0st)","0.600"
"443","Bilal Khan (OMAN)","2017-2020","23","23","3","3","0","0","3","1 (1ct 0st)","0.130"
"444","Bilal Zalmai (Aut)","2019-2019","5","5","3","3","0","0","3","2 (2ct 0st)","0.600"
"445","C Bisson (JER)","2019-2019","14","14","3","3","0","0","3","1 (1ct 0st)","0.214"
"446","J Butler (GUE)","2019-2020","10","10","3","3","0","0","3","1 (1ct 0st)","0.300"
"447","C Chete (MWI)","2019-2019","2","2","3","3","0","3","0","2 (2ct 0st)","1.500"
"448","LA Collado (GIBR)","2019-2019","4","4","3","2","1","2","0","1 (1ct 0st)","0.750"
"449","CJ Dala (SA)","2018-2021","10","10","3","3","0","0","3","1 (1ct 0st)","0.300"
"450","Delawar Khan (DEN)","2019-2019","9","7","3","3","0","0","3","2 (2ct 0st)","0.428"
"451","BFW de Leede (NL)","2018-2019","8","8","3","3","0","0","3","1 (1ct 0st)","0.375"
"452","JL Denly (ENG)","2018-2020","8","8","3","3","0","0","3","1 (1ct 0st)","0.375"
"453","JP Duminy (SA)","2016-2019","13","13","3","3","0","0","3","1 (1ct 0st)","0.230"
"454","N Dutta (CAN)","2019-2019","11","11","3","3","0","0","3","2 (2ct 0st)","0.272"
"455","AC Evans (SCOT)","2018-2019","16","16","3","3","0","0","3","1 (1ct 0st)","0.187"
"456","CH Gayle (WI)","2016-2021","15","15","3","3","0","0","3","1 (1ct 0st)","0.200"
"457","SC Getkate (IRE)","2019-2020","15","15","3","3","0","0","3","2 (2ct 0st)","0.200"
"458","D Gim (NGA)","2019-2019","6","6","3","3","0","0","3","2 (2ct 0st)","0.500"
"459","BD Glover (NL)","2019-2019","19","19","3","3","0","0","3","1 (1ct 0st)","0.157"
"460","LF Goncalves ()","2019-2019","3","3","3","1","2","1","0","2 (1ct 1st)","1.000"
"461","H Gori (CZK-R)","2019-2020","11","11","3","3","0","0","3","1 (1ct 0st)","0.272"
"462","Z Groenewald (NAM)","2019-2019","10","10","3","3","0","0","3","1 (1ct 0st)","0.300"
"463","Haider Ali (PAK)","2020-2021","10","10","3","3","0","0","3","1 (1ct 0st)","0.300"
"464","BE Hendricks (SA)","2017-2020","9","9","3","3","0","0","3","2 (2ct 0st)","0.333"
"465","Ibrarul Haq (Saudi)","2019-2019","5","5","3","3","0","0","3","3 (3ct 0st)","0.600"
"466","Imrul Kayes (BDESH)","2017-2017","6","6","3","3","0","0","3","1 (1ct 0st)","0.500"
"467","Inam-ul-Haq (QAT)","2019-2019","11","11","3","3","0","0","3","1 (1ct 0st)","0.272"
"468","H Ivanov (BUL)","2019-2020","8","7","3","3","0","2","1","1 (1ct 0st)","0.428"
"469","KA Jamieson (NZ)","2020-2021","8","8","3","3","0","0","3","2 (2ct 0st)","0.375"
"470","S Jora (NEPAL)","2019-2019","6","6","3","3","0","0","3","1 (1ct 0st)","0.500"
"471","Junaid Siddique (UAE)","2019-2020","13","13","3","3","0","0","3","1 (1ct 0st)","0.230"
"472","I Katzarski (BUL)","2019-2019","3","3","3","3","0","0","3","2 (2ct 0st)","1.000"
"473","S Kaveri (Mex)","2019-2019","7","7","3","3","0","0","3","2 (2ct 0st)","0.428"
"474","Khalid Latif (PAK)","2016-2016","6","6","3","3","0","0","3","1 (1ct 0st)","0.500"
"475","UT Khawaja (AUS)","2016-2016","6","6","3","3","0","0","3","1 (1ct 0st)","0.500"
"476","Khurram Nawaz (OMAN)","2017-2020","19","19","3","3","0","0","3","1 (1ct 0st)","0.157"
"477","J Kila (PNG)","2019-2019","12","12","3","3","0","0","3","2 (2ct 0st)","0.250"
"478","AK Kitchen (NZ)","2017-2018","5","4","3","3","0","0","3","2 (2ct 0st)","0.750"
"479","IGTR Kumara (Mald)","2020-2020","3","3","3","3","0","0","3","3 (3ct 0st)","1.000"
"480","UKPW Kumaranayaka (KUW)","2019-2020","7","7","3","3","0","0","3","1 (1ct 0st)","0.428"
"481","S Lamichhane (ICC/NEPAL)","2018-2020","21","21","3","3","0","0","3","1 (1ct 0st)","0.142"
"482","A Lark (Aut)","2019-2019","5","5","3","3","0","0","3","1 (1ct 0st)","0.600"
"483","TWM Latham (NZ)","2017-2017","1","1","3","3","0","3","0","3 (3ct 0st)","3.000"
"484","KS Leverock (BMUDA)","2019-2019","12","12","3","3","0","0","3","1 (1ct 0st)","0.250"
"485","N Madziva (ZIM)","2016-2019","9","9","3","3","0","0","3","1 (1ct 0st)","0.333"
"486","WJ Malinda (Mald)","2019-2019","3","3","3","3","0","0","3","2 (2ct 0st)","1.000"
"487","Mamoon Latif (Belg)","2019-2020","7","7","3","3","0","0","3","2 (2ct 0st)","0.428"
"488","A Manepalli (LUX)","2020-2020","2","2","3","3","0","3","0","3 (3ct 0st)","1.500"
"489","AD Mathews (SL)","2016-2021","15","15","3","3","0","0","3","2 (2ct 0st)","0.200"
"490","Md Shafiqul Haque (THAI)","2019-2019","4","4","3","1","2","1","0","1 (1ct 0st)","0.750"
"491","GP Meade (ITA)","2019-2019","8","7","3","3","0","0","3","1 (1ct 0st)","0.428"
"492","BMAJ Mendis (SL)","2018-2018","6","6","3","3","0","0","3","2 (2ct 0st)","0.500"
"493","P Mishra (BUL)","2019-2020","10","9","3","3","0","0","3","2 (2ct 0st)","0.333"
"494","Mohammad Amin (KUW)","2019-2020","9","9","3","3","0","0","3","1 (1ct 0st)","0.333"
"495","Mohammad Naveed (UAE)","2016-2019","17","17","3","3","0","0","3","1 (1ct 0st)","0.176"
"496","Mohammad Saifuddin (BDESH)","2017-2020","15","15","3","3","0","0","3","1 (1ct 0st)","0.200"
"497","Muhammad Kashif (KUW)","2019-2020","15","15","3","3","0","0","3","1 (1ct 0st)","0.200"
"498","T Munyonga (ZIM)","2019-2019","5","5","3","3","0","0","3","2 (2ct 0st)","0.600"
"499","Najeeb Tarakai (AFG)","2016-2019","10","10","3","3","0","0","3","2 (2ct 0st)","0.300"
"500","Naveed Ahmed (CZK-R)","2019-2020","10","10","3","3","0","0","3","2 (2ct 0st)","0.300"
"501","A Ndlovu (ZIM)","2019-2019","3","3","3","3","0","0","3","2 (2ct 0st)","1.000"
"502","SO Ngoche (KENYA)","2019-2019","9","9","3","3","0","0","3","1 (1ct 0st)","0.333"
"503","F Nsubuga (UGA)","2019-2020","6","6","3","3","0","0","3","1 (1ct 0st)","0.500"
"504","AR Patel (INDIA)","2016-2021","8","8","3","3","0","0","3","2 (2ct 0st)","0.375"
"505","RB Patel (BUL)","2020-2020","7","6","3","3","0","0","3","1 (1ct 0st)","0.500"
"506","WTS Porterfield (IRE)","2016-2018","13","13","3","3","0","0","3","1 (1ct 0st)","0.230"
"507","S Prasanna (SL)","2016-2017","14","14","3","3","0","0","3","2 (2ct 0st)","0.214"
"508","S Qeshile (SA)","2019-2019","2","2","3","3","0","3","0","2 (2ct 0st)","1.500"
"509","K Rabada (SA)","2016-2020","13","13","3","3","0","0","3","1 (1ct 0st)","0.230"
"510","LN Rajbanshi (NEPAL)","2018-2019","12","12","3","3","0","0","3","1 (1ct 0st)","0.250"
"511","S Ravikumar (CRC)","2019-2019","3","3","3","3","0","0","3","2 (2ct 0st)","1.000"
"512","B Regmi (NEPAL)","2018-2019","7","7","3","3","0","0","3","1 (1ct 0st)","0.428"
"513","KA Reynolds (Blz)","2019-2019","3","3","3","3","0","0","3","2 (2ct 0st)","1.000"
"514","Rizwan Cheema (CAN)","2019-2019","8","8","3","3","0","0","3","1 (1ct 0st)","0.375"
"515","MJ Ross (ITA)","2019-2019","8","7","3","3","0","0","3","2 (2ct 0st)","0.428"
"516","Saad Bin Zafar (CAN)","2019-2019","11","11","3","3","0","0","3","1 (1ct 0st)","0.272"
"517","NA Saini (INDIA)","2019-2020","10","9","3","3","0","0","3","2 (2ct 0st)","0.333"
"518","V Saini (ROM)","2020-2020","4","4","3","3","0","0","3","2 (2ct 0st)","0.750"
"519","Sajid Cheema (Saudi)","2019-2020","7","7","3","3","0","0","3","1 (1ct 0st)","0.428"
"520","DJG Sammy (WI/World)","2016-2017","7","7","3","3","0","0","3","1 (1ct 0st)","0.428"
"521","SV Samson (INDIA)","2020-2020","6","6","3","2","1","0","2","1 (1ct 0st)","0.500"
"522","BM Scholtz (NAM)","2019-2019","14","14","3","3","0","0","3","1 (1ct 0st)","0.214"
"523","NK Shetty (Mex)","2019-2019","2","2","3","3","0","0","3","2 (2ct 0st)","1.500"
"524","Sidhant Singh (SGP)","2019-2020","11","11","3","3","0","0","3","1 (1ct 0st)","0.272"
"525","P Silas (Botsw)","2019-2019","4","4","3","3","0","0","3","1 (1ct 0st)","0.750"
"526","L Sipamla (SA)","2019-2021","9","9","3","3","0","0","3","1 (1ct 0st)","0.333"
"527","MWR Stokes (GUE)","2019-2019","9","9","3","3","0","0","3","1 (1ct 0st)","0.333"
"528","CR Suryawanshi (SGP)","2019-2019","3","3","3","3","0","0","3","1 (1ct 0st)","1.000"
"529","Tauqeer Hussain (ESP)","2019-2020","6","6","3","3","0","0","3","1 (1ct 0st)","0.500"
"530","JE Taylor (WI)","2016-2018","10","10","3","3","0","0","3","1 (1ct 0st)","0.300"
"531","OFJ Tonuu (Samoa)","2019-2019","4","4","3","3","0","3","0","1 (1ct 0st)","0.750"
"532","I Udana (SL)","2017-2020","23","22","3","3","0","0","3","2 (2ct 0st)","0.136"
"533","JD Unadkat (INDIA)","2016-2018","10","10","3","3","0","0","3","1 (1ct 0st)","0.300"
"534","JNT Vare (PNG)","2017-2017","3","3","3","3","0","3","0","3 (3ct 0st)","1.000"
"535","S Vesawkar (NEPAL)","2018-2019","7","7","3","3","0","0","3","1 (1ct 0st)","0.428"
"536","TP Visee (NL)","2017-2019","25","24","3","3","0","0","3","1 (1ct 0st)","0.125"
"537","HR Walsh (USA/WI)","2019-2020","17","16","3","3","0","0","3","1 (1ct 0st)","0.187"
"538","Waqas Barkat (HKG)","2017-2020","20","20","3","3","0","0","3","1 (1ct 0st)","0.150"
"539","UT Yadav (INDIA)","2018-2019","6","6","3","3","0","0","3","1 (1ct 0st)","0.500"
"540","KJ Young (Blz)","2019-2019","3","3","3","3","0","3","0","1 (1ct 0st)","1.000"
"541","SA Abbott (AUS)","2019-2020","4","4","2","2","0","0","2","2 (2ct 0st)","0.500"
"542","Abdullah Akbarjan (Aut)","2019-2019","5","5","2","2","0","0","2","1 (1ct 0st)","0.400"
"543","Abdul Wahid (Saudi)","2019-2020","8","8","2","2","0","0","2","1 (1ct 0st)","0.250"
"544","AS Abioye (NGA)","2019-2019","5","5","2","2","0","0","2","1 (1ct 0st)","0.400"
"545","IKO Aboagye (Ghana)","2019-2019","4","4","2","2","0","0","2","1 (1ct 0st)","0.500"
"546","Abu Hider (BDESH)","2018-2018","8","8","2","2","0","0","2","1 (1ct 0st)","0.250"
"547","Abdul Hashmi (DEN)","2019-2019","8","6","2","1","1","1","0","1 (1ct 0st)","0.333"
"548","Adil Butt (Saudi)","2020-2020","3","3","2","2","0","0","2","1 (1ct 0st)","0.666"
"549","Ahmed Shehzad (PAK)","2016-2019","18","18","2","2","0","0","2","1 (1ct 0st)","0.111"
"550","CM Akachukwu (NGA)","2019-2019","8","8","2","2","0","0","2","2 (2ct 0st)","0.250"
"551","AD Algar (ESP)","2020-2020","1","1","2","2","0","2","0","2 (2ct 0st)","2.000"
"552","Al-Amin Hossain (BDESH)","2016-2020","9","9","2","2","0","0","2","1 (1ct 0st)","0.222"
"553","Amjad Javed (UAE)","2016-2017","7","7","2","2","0","0","2","1 (1ct 0st)","0.285"
"554","Amjad Khan (UAE)","2016-2016","3","3","2","2","0","0","2","1 (1ct 0st)","0.666"
"555","Amjad Sher (Fin)","2019-2019","5","5","2","2","0","0","2","1 (1ct 0st)","0.400"
"556","Anique Uddin (DEN)","2019-2019","6","5","2","2","0","0","2","1 (1ct 0st)","0.400"
"557","R Ankad (Mex)","2019-2019","8","8","2","2","0","0","2","1 (1ct 0st)","0.250"
"558","Anshuman Rath (HKG)","2016-2017","4","4","2","2","0","0","2","1 (1ct 0st)","0.500"
"559","Anwar Arudin (MAL)","2019-2020","17","16","2","2","0","0","2","1 (1ct 0st)","0.125"
"560","Anwar Rahman (MAL)","2019-2020","11","10","2","2","0","0","2","1 (1ct 0st)","0.200"
"561","Aphsal Ashraf (KUW)","2020-2020","5","5","2","2","0","0","2","1 (1ct 0st)","0.400"
"562","Areeb Quadir (Fin)","2019-2019","2","2","2","2","0","0","2","2 (2ct 0st)","1.000"
"563","Ashfaq Ahmed (UAE)","2018-2019","12","12","2","2","0","0","2","1 (1ct 0st)","0.166"
"564","R Ashwin (INDIA)","2016-2017","7","7","2","2","0","0","2","1 (1ct 0st)","0.285"
"565","Asrar Ahmed ()","2019-2019","3","3","2","2","0","0","2","1 (1ct 0st)","0.666"
"566","S Badree (WI/World)","2016-2018","29","29","2","2","0","0","2","2 (2ct 0st)","0.068"
"567","AA Banner (Blz)","2019-2019","3","3","2","2","0","0","2","2 (2ct 0st)","0.666"
"568","GG Banner (Blz)","2019-2019","3","3","2","2","0","0","2","2 (2ct 0st)","0.666"
"569","LJ Barker (GUE)","2019-2020","10","10","2","2","0","0","2","1 (1ct 0st)","0.200"
"570","W Barresi (NL)","2017-2019","10","9","2","1","1","1","0","1 (1ct 0st)","0.222"
"571","A Bhagwat (HKG)","2019-2019","4","4","2","2","0","2","0","2 (2ct 0st)","0.500"
"572","M Bhanuka (SL)","2019-2019","2","2","2","2","0","2","0","1 (1ct 0st)","1.000"
"573","DAJ Bracewell (NZ)","2017-2019","4","3","2","2","0","0","2","2 (2ct 0st)","0.666"
"574","DM Bravo (WI)","2018-2019","8","8","2","2","0","0","2","2 (2ct 0st)","0.250"
"575","PR Brown (ENG)","2019-2019","4","4","2","2","0","0","2","1 (1ct 0st)","0.500"
"576","C Carter (HKG)","2016-2017","3","3","2","1","1","1","0","1 (1ct 0st)","0.666"
"577","VD Chandra (PNM)","2019-2019","3","3","2","2","0","2","0","1 (1ct 0st)","0.666"
"578","BB Chari (ZIM)","2019-2019","3","3","2","2","0","0","2","1 (1ct 0st)","0.666"
"579","J Charles (WI)","2016-2016","10","10","2","2","0","0","2","1 (1ct 0st)","0.200"
"580","TL Chatara (ZIM)","2016-2020","12","12","2","2","0","0","2","1 (1ct 0st)","0.166"
"581","G Chaturvedi (MLT)","2019-2020","5","5","2","2","0","0","2","2 (2ct 0st)","0.400"
"582","WJ Cope (LUX)","2020-2020","4","4","2","2","0","0","2","2 (2ct 0st)","0.500"
"583","F Damiao Couana (Moz)","2019-2019","7","6","2","2","0","0","2","1 (1ct 0st)","0.333"
"584","P Danci (ROM)","2019-2020","4","4","2","2","0","0","2","2 (2ct 0st)","0.500"
"585","S Davizi (CZK-R)","2019-2020","6","6","2","2","0","0","2","1 (1ct 0st)","0.333"
"586","LA Dawson (ENG)","2016-2018","6","6","2","2","0","0","2","1 (1ct 0st)","0.333"
"587","TB de Bruyn (SA)","2017-2017","2","2","2","2","0","0","2","2 (2ct 0st)","1.000"
"588","CD de Lange (SCOT)","2017-2017","4","4","2","2","0","0","2","1 (1ct 0st)","0.500"
"589","R Dhawan (INDIA)","2016-2016","1","1","2","2","0","0","2","2 (2ct 0st)","2.000"
"590","AB Dursak (TKY)","2019-2019","4","4","2","2","0","0","2","2 (2ct 0st)","0.500"
"591","L Emilio (Moz)","2019-2019","5","4","2","2","0","0","2","1 (1ct 0st)","0.500"
"592","GDR Eranga (CAN)","2019-2019","9","9","2","2","0","0","2","1 (1ct 0st)","0.222"
"593","Faisal Khan (Saudi)","2019-2020","7","7","2","2","0","0","2","1 (1ct 0st)","0.285"
"594","Faran Afzal (ESP)","2019-2019","9","9","2","2","0","0","2","1 (1ct 0st)","0.222"
"595","Fayyaz Butt (OMAN)","2019-2019","14","14","2","2","0","0","2","1 (1ct 0st)","0.142"
"596","A Ferguson (Arg)","2019-2019","5","5","2","2","0","0","2","1 (1ct 0st)","0.400"
"597","N Pradeep (SL)","2016-2021","15","15","2","2","0","0","2","1 (1ct 0st)","0.133"
"598","NJ Ferraby (JER)","2019-2019","14","14","2","2","0","0","2","1 (1ct 0st)","0.142"
"599","JD Freyone (GIBR)","2019-2019","4","4","2","2","0","0","2","2 (2ct 0st)","0.500"
"600","GC Galanis ()","2019-2019","2","2","2","2","0","0","2","1 (1ct 0st)","1.000"
"601","V Ganesan (GER)","2019-2020","6","6","2","2","0","0","2","1 (1ct 0st)","0.333"
"602","CJ Gannon (USA)","2019-2019","4","4","2","2","0","0","2","2 (2ct 0st)","0.500"
"603","R Gaznavi (SGP)","2019-2020","5","5","2","2","0","0","2","1 (1ct 0st)","0.400"
"604","Habib Ahmadzai (Aut)","2019-2019","2","2","2","2","0","0","2","1 (1ct 0st)","1.000"
"605","Jandu Hamoud (KUW)","2019-2019","6","6","2","2","0","0","2","1 (1ct 0st)","0.333"
"606","Haris Sohail (PAK)","2018-2019","10","10","2","2","0","0","2","2 (2ct 0st)","0.200"
"607","C Hauptfleisch (Caym)","2019-2019","5","5","2","1","1","1","0","1 (1ct 0st)","0.400"
"608","JR Hazlewood (AUS)","2016-2020","4","4","2","2","0","0","2","1 (1ct 0st)","0.500"
"609","Hazratullah Zazai (AFG)","2016-2020","15","15","2","2","0","0","2","1 (1ct 0st)","0.133"
"610","MC Henriques (AUS)","2016-2020","10","10","2","2","0","0","2","1 (1ct 0st)","0.200"
"611","L Hermida (Mex)","2019-2019","5","5","2","2","0","0","2","1 (1ct 0st)","0.400"
"612","D Heyliger (CAN)","2019-2019","11","11","2","2","0","0","2","1 (1ct 0st)","0.181"
"613","R Heyns (LUX)","2020-2020","2","2","2","2","0","0","2","2 (2ct 0st)","1.000"
"614","Hirenkumar Patel (Chile)","2019-2019","4","4","2","2","0","0","2","1 (1ct 0st)","0.500"
"615","S Hirugade (Mex)","2019-2019","6","6","2","2","0","0","2","1 (1ct 0st)","0.333"
"616","Z Hoque (THAI)","2019-2020","7","7","2","2","0","0","2","1 (1ct 0st)","0.285"
"617","Imran Anwar (BHR)","2019-2020","8","8","2","2","0","0","2","1 (1ct 0st)","0.250"
"618","Imran Ali (KUW)","2019-2019","4","4","2","2","0","0","2","2 (2ct 0st)","0.500"
"619","Imran Ali Butt (BHR)","2019-2020","8","8","2","1","1","1","0","1 (1ct 0st)","0.250"
"620","Ismat Ullah ()","2019-2019","4","4","2","2","0","0","2","1 (1ct 0st)","0.500"
"621","B Ivanov (BUL)","2019-2020","8","7","2","2","0","0","2","2 (2ct 0st)","0.285"
"622","Izatullah Dawlatzai (GER)","2019-2020","12","12","2","2","0","0","2","2 (2ct 0st)","0.166"
"623","DF Jacobs (THAI)","2019-2020","8","8","2","2","0","0","2","1 (1ct 0st)","0.250"
"624","GSNFG Jayasuriya (SL)","2016-2020","8","8","2","2","0","0","2","1 (1ct 0st)","0.250"
"625","Karweng NG (PHI)","2019-2019","4","4","2","2","0","0","2","2 (2ct 0st)","0.500"
"626","Khushdil Shah (PAK)","2019-2021","9","9","2","2","0","0","2","1 (1ct 0st)","0.222"
"627","M Klinger (AUS)","2017-2017","3","3","2","2","0","0","2","1 (1ct 0st)","0.666"
"628","JS Kundi (KENYA)","2019-2019","6","6","2","2","0","0","2","1 (1ct 0st)","0.333"
"629","S Kushretha (LUX)","2020-2020","4","4","2","2","0","0","2","1 (1ct 0st)","0.500"
"630","AV Lalcheta (OMAN)","2017-2019","6","6","2","2","0","0","2","1 (1ct 0st)","0.333"
"631","LC Le Tissier (GUE)","2019-2020","10","10","2","2","0","0","2","2 (2ct 0st)","0.200"
"632","JB Little (IRE)","2016-2020","17","17","2","2","0","0","2","1 (1ct 0st)","0.117"
"633","AR McBrine (IRE)","2016-2017","8","8","2","2","0","0","2","2 (2ct 0st)","0.250"
"634","W Madhevere (ZIM)","2020-2021","6","6","2","2","0","0","2","1 (1ct 0st)","0.333"
"635","NA Maiolo (ITA)","2019-2019","8","7","2","2","0","0","2","1 (1ct 0st)","0.285"
"636","JN Malan (SA)","2019-2021","5","5","2","2","0","0","2","1 (1ct 0st)","0.400"
"637","G Manan (ROM)","2019-2020","6","6","2","2","0","0","2","1 (1ct 0st)","0.333"
"638","A Manousis ()","2019-2019","3","3","2","2","0","0","2","1 (1ct 0st)","0.666"
"639","T Maruma (ZIM)","2016-2019","4","4","2","2","0","0","2","1 (1ct 0st)","0.500"
"640","WT Mashinge (ZIM)","2019-2019","2","2","2","2","0","0","2","2 (2ct 0st)","1.000"
"641","B Mavuta (ZIM)","2018-2021","4","4","2","2","0","0","2","1 (1ct 0st)","0.500"
"642","Mehran Khan (OMAN)","2017-2019","8","8","2","2","0","0","2","1 (1ct 0st)","0.250"
"643","SF Mire (ZIM)","2018-2019","9","9","2","2","0","0","2","1 (1ct 0st)","0.222"
"644","Mohammad Ghazanfar (HKG)","2019-2019","5","5","2","2","0","0","2","1 (1ct 0st)","0.400"
"645","Mohammed Asghar (KUW)","2019-2019","4","4","2","2","0","0","2","1 (1ct 0st)","0.500"
"646","Mohammed Nurji (MWI)","2019-2019","6","6","2","2","0","0","2","1 (1ct 0st)","0.333"
"647","CH Morris (SA)","2016-2019","15","15","2","2","0","0","2","1 (1ct 0st)","0.133"
"648","CB Mpofu (ZIM)","2018-2020","12","12","2","2","0","0","2","1 (1ct 0st)","0.166"
"649","Muhammad Nadeem (Saudi)","2019-2019","5","5","2","2","0","0","2","2 (2ct 0st)","0.400"
"650","Muhammad Younis (BHR)","2020-2020","3","3","2","2","0","0","2","2 (2ct 0st)","0.666"
"651","D Muhumuza (UGA)","2019-2020","7","7","2","2","0","0","2","1 (1ct 0st)","0.285"
"652","RG Mukasa (UGA)","2019-2020","6","6","2","2","0","0","2","1 (1ct 0st)","0.333"
"653","J Mulder (IRE)","2016-2017","8","8","2","2","0","0","2","1 (1ct 0st)","0.250"
"654","GBW Munaweera (QAT)","2019-2020","12","12","2","2","0","0","2","1 (1ct 0st)","0.166"
"655","G Murali (CRC)","2019-2019","3","3","2","2","0","2","0","1 (1ct 0st)","0.666"
"656","TK Musakanda (ZIM)","2018-2021","7","7","2","2","0","0","2","1 (1ct 0st)","0.285"
"657","Musawar Shah (QAT)","2019-2020","4","4","2","2","0","0","2","1 (1ct 0st)","0.500"
"658","LA Musiani (Arg)","2019-2019","5","5","2","2","0","0","2","1 (1ct 0st)","0.400"
"659","Muslim Yar (GER)","2019-2020","8","8","2","2","0","0","2","1 (1ct 0st)","0.250"
"660","CT Mutombodzi (ZIM)","2016-2020","12","12","2","2","0","0","2","1 (1ct 0st)","0.166"
"661","B Muzarabani (ZIM)","2018-2021","10","10","2","2","0","0","2","1 (1ct 0st)","0.200"
"662","Nadeem Ahmed (HKG)","2016-2017","4","4","2","2","0","0","2","2 (2ct 0st)","0.500"
"663","Nanda Kumar (CRC)","2019-2019","3","3","2","2","0","0","2","2 (2ct 0st)","0.666"
"664","N Nankov (BUL)","2019-2020","4","4","2","2","0","0","2","1 (1ct 0st)","0.500"
"665","Naseem Khushi (OMAN)","2017-2020","13","13","2","2","0","0","2","1 (1ct 0st)","0.153"
"666","Nawazish Jezuli (Saudi)","2019-2019","1","1","2","2","0","2","0","2 (2ct 0st)","2.000"
"667","Najmul Hossain Shanto (BDESH)","2019-2019","2","2","2","2","0","0","2","1 (1ct 0st)","1.000"
"668","Nazmul Islam (BDESH)","2018-2018","13","13","2","2","0","0","2","1 (1ct 0st)","0.153"
"669","Nazwan Ismail (Mald)","2019-2020","4","4","2","2","0","0","2","1 (1ct 0st)","0.500"
"670","K Nestor (GIBR)","2019-2019","4","4","2","2","0","0","2","1 (1ct 0st)","0.500"
"671","PM Nevill (AUS)","2016-2016","6","6","2","1","1","1","0","1 (1ct 0st)","0.333"
"672","L Ngidi (SA)","2017-2020","16","16","2","2","0","0","2","1 (1ct 0st)","0.125"
"673","TW Nightingale (GUE)","2020-2020","1","1","2","2","0","0","2","2 (2ct 0st)","2.000"
"674","G Nikitas ()","2019-2019","2","2","2","0","2","0","0","2 (0ct 2st)","1.000"
"675","D Nikolov (BUL)","2019-2020","7","7","2","2","0","0","2","1 (1ct 0st)","0.285"
"676","Noor Ali Zadran (AFG)","2016-2017","4","4","2","2","0","0","2","1 (1ct 0st)","0.500"
"677","Noor Momand (Belg)","2019-2019","2","2","2","2","0","2","0","1 (1ct 0st)","1.000"
"678","Nurul Hasan (BDESH)","2017-2017","3","3","2","2","0","2","0","1 (1ct 0st)","0.666"
"679","GH O'Brien (BMUDA)","2019-2019","8","8","2","2","0","0","2","1 (1ct 0st)","0.250"
"680","SA Okpe (NGA)","2019-2019","8","8","2","2","0","0","2","1 (1ct 0st)","0.250"
"681","LN Oluoch (KENYA)","2019-2019","9","9","2","2","0","0","2","1 (1ct 0st)","0.222"
"682","AA Onikoyi (NGA)","2019-2019","9","9","2","2","0","2","0","1 (1ct 0st)","0.222"
"683","HC Overdijk (NL)","2018-2019","4","3","2","2","0","0","2","2 (2ct 0st)","0.666"
"684","AM Oyede (NGA)","2019-2019","8","8","2","2","0","0","2","2 (2ct 0st)","0.250"
"685","AE Paraam (SGP)","2019-2019","3","3","2","2","0","0","2","1 (1ct 0st)","0.666"
"686","KMA Paul (WI)","2018-2020","20","20","2","2","0","0","2","1 (1ct 0st)","0.100"
"687","T Perera (Botsw)","2019-2019","6","6","2","2","0","0","2","1 (1ct 0st)","0.333"
"688","S Periyalwar (ROM)","2019-2020","6","6","2","2","0","0","2","1 (1ct 0st)","0.333"
"689","P Suanchuai (THAI)","2020-2020","4","4","2","1","1","1","0","1 (1ct 0st)","0.500"
"690","K Pierre (WI)","2018-2020","10","10","2","2","0","0","2","1 (1ct 0st)","0.200"
"691","JE Pitcher (BMUDA)","2019-2019","3","3","2","2","0","0","2","2 (2ct 0st)","0.666"
"692","A Poulose (OMAN)","2017-2017","3","3","2","2","0","0","2","1 (1ct 0st)","0.666"
"693","A Pusthay (Fin)","2019-2019","5","5","2","2","0","0","2","1 (1ct 0st)","0.400"
"694","Raag Kapur (HKG)","2019-2019","4","4","2","2","0","0","2","1 (1ct 0st)","0.500"
"695","AM Rahane (INDIA)","2016-2016","3","3","2","2","0","0","2","1 (1ct 0st)","0.666"
"696","S Rakshit (CZK-R)","2019-2019","6","6","2","2","0","0","2","1 (1ct 0st)","0.333"
"697","AT Rayudu (INDIA)","2016-2016","3","3","2","2","0","0","2","2 (2ct 0st)","0.666"
"698","GA Reynold (Blz)","2019-2019","3","3","2","2","0","0","2","2 (2ct 0st)","0.666"
"699","LH Rodrigues ()","2019-2019","4","4","2","2","0","0","2","1 (1ct 0st)","0.500"
"700","S Rossi (Arg)","2019-2019","5","5","2","2","0","0","2","1 (1ct 0st)","0.400"
"701","S Saeed (Mald)","2019-2019","5","5","2","2","0","0","2","2 (2ct 0st)","0.400"
"702","Sahibzada Farhan (PAK)","2018-2018","3","3","2","2","0","0","2","2 (2ct 0st)","0.666"
"703","J Salazar (Peru)","2019-2019","2","2","2","2","0","0","2","1 (1ct 0st)","1.000"
"704","DR Sams (AUS)","2020-2021","4","4","2","2","0","0","2","2 (2ct 0st)","0.500"
"705","R Sandaruwan (KUW)","2019-2020","15","15","2","2","0","0","2","1 (1ct 0st)","0.133"
"706","Saqib Zulfiqar (NL)","2018-2019","6","6","2","2","0","0","2","2 (2ct 0st)","0.333"
"707","Sarfaraz Ali (BHR)","2019-2020","8","8","2","2","0","0","2","1 (1ct 0st)","0.250"
"708","A Sathya (Mex)","2019-2019","3","3","2","2","0","0","2","1 (1ct 0st)","0.666"
"709","BV Save (MAL)","2020-2020","2","2","2","2","0","0","2","2 (2ct 0st)","1.000"
"710","Sayed Monib (KUW)","2020-2020","5","5","2","2","0","0","2","1 (1ct 0st)","0.400"
"711","Shaheryar Butt (Belg)","2019-2020","7","7","2","2","0","0","2","1 (1ct 0st)","0.285"
"712","Shaikh Ashraf (Peru)","2019-2019","4","4","2","2","0","0","2","2 (2ct 0st)","0.500"
"713","PH Shamdasani (Peru)","2019-2019","4","4","2","2","0","0","2","1 (1ct 0st)","0.500"
"714","V Shankar (INDIA)","2018-2019","9","9","2","2","0","0","2","1 (1ct 0st)","0.222"
"715","Shoaib Ali (Saudi)","2019-2020","8","8","2","2","0","0","2","2 (2ct 0st)","0.250"
"716","Shoaib Qureshi (Fin)","2019-2019","5","5","2","2","0","0","2","1 (1ct 0st)","0.400"
"717","Sikandar Raza (ZIM)","2016-2021","13","13","2","2","0","0","2","1 (1ct 0st)","0.153"
"718","Sikander Zulfiqar (NL)","2018-2019","9","9","2","2","0","0","2","1 (1ct 0st)","0.222"
"719","K Sinclair (WI)","2021-2021","3","3","2","2","0","0","2","1 (1ct 0st)","0.666"
"720","TAM Siriwardana (SL)","2016-2017","8","8","2","2","0","0","2","1 (1ct 0st)","0.250"
"721","S Smith (BMUDA)","2019-2019","5","5","2","2","0","2","0","1 (1ct 0st)","0.400"
"722","S Snater (NL)","2018-2019","13","12","2","2","0","0","2","1 (1ct 0st)","0.166"
"723","H Srinivasan (GER)","2019-2019","1","1","2","1","1","1","0","2 (1ct 1st)","2.000"
"724","F Stoman (PORT)","2019-2019","4","4","2","1","1","1","0","2 (1ct 1st)","0.500"
"725","DC Stovell (BMUDA)","2019-2019","6","6","2","2","0","0","2","1 (1ct 0st)","0.333"
"726","GM Strydom (Caym)","2019-2019","6","6","2","2","0","0","2","1 (1ct 0st)","0.333"
"727","JTS Sumerauer (JER)","2019-2019","8","8","2","2","0","0","2","1 (1ct 0st)","0.250"
"728","K Suttisan (THAI)","2019-2019","2","2","2","2","0","0","2","2 (2ct 0st)","1.000"
"729","Syazrul Idrus (MAL)","2019-2020","10","10","2","2","0","0","2","1 (1ct 0st)","0.200"
"730","Tahir Dar (BHR)","2019-2019","4","4","2","2","0","0","2","1 (1ct 0st)","0.500"
"731","RA Thomas (CAN)","2019-2019","8","8","2","2","0","0","2","1 (1ct 0st)","0.250"
"732","GJ Thompson (IRE)","2016-2019","10","10","2","2","0","0","2","1 (1ct 0st)","0.200"
"733","DT Tiripano (ZIM)","2016-2021","9","9","2","2","0","0","2","1 (1ct 0st)","0.222"
"734","T Tshose (Botsw)","2019-2019","2","2","2","2","0","0","2","1 (1ct 0st)","1.000"
"735","E Ul Haq (NOR)","2019-2019","5","5","2","2","0","0","2","1 (1ct 0st)","0.400"
"736","R Ulutuna (TKY)","2019-2019","4","4","2","2","0","2","0","2 (2ct 0st)","0.500"
"737","Umar Adam (Mald)","2019-2020","14","14","2","2","0","0","2","1 (1ct 0st)","0.142"
"738","R van der Merwe (Arg)","2019-2019","5","5","2","2","0","0","2","1 (1ct 0st)","0.400"
"739","Vichanath Singh (THAI)","2019-2020","8","8","2","2","0","0","2","1 (1ct 0st)","0.250"
"740","Vinod Kumar (ESP)","2019-2020","4","4","2","2","0","0","2","2 (2ct 0st)","0.500"
"741","Wahab Riaz (PAK)","2016-2020","18","18","2","2","0","0","2","1 (1ct 0st)","0.111"
"742","Waheed Ahmed (UAE)","2019-2020","15","15","2","2","0","0","2","1 (1ct 0st)","0.133"
"743","CD Wallace (SCOT)","2017-2019","11","11","2","2","0","1","1","1 (1ct 0st)","0.181"
"744","Washeem Abbas (MLT)","2019-2020","5","5","2","2","0","0","2","1 (1ct 0st)","0.400"
"745","SR Watson (AUS)","2016-2016","4","4","2","2","0","0","2","1 (1ct 0st)","0.500"
"746","D Wiese (SA)","2016-2016","3","3","2","2","0","0","2","1 (1ct 0st)","0.666"
"747","CG Williams (NAM)","2019-2019","13","13","2","2","0","0","2","1 (1ct 0st)","0.153"
"748","OR Willis (Caym)","2019-2019","3","3","2","1","1","0","1","1 (1ct 0st)","0.666"
"749","C Wright (Caym)","2019-2019","6","6","2","2","0","0","2","1 (1ct 0st)","0.333"
"750","Yasar Haroon ()","2019-2019","4","4","2","2","0","0","2","1 (1ct 0st)","0.500"
"751","Yusuf Ebrahim (PNM)","2019-2019","3","3","2","2","0","0","2","2 (2ct 0st)","0.666"
"752","Zishan Shah (DEN)","2019-2019","6","4","2","2","0","0","2","1 (1ct 0st)","0.500"
"753","M Abdulla (MWI)","2019-2019","5","5","1","1","0","0","1","1 (1ct 0st)","0.200"
"754","Abdul Shakoor (UAE)","2019-2019","2","2","1","0","1","0","0","1 (0ct 1st)","0.500"
"755","Abraash Khan (CAN)","2019-2019","7","7","1","1","0","0","1","1 (1ct 0st)","0.142"
"756","Abu Jayed (BDESH)","2018-2018","3","3","1","1","0","0","1","1 (1ct 0st)","0.333"
"757","AG Achar (SGP)","2019-2020","5","5","1","1","0","0","1","1 (1ct 0st)","0.200"
"758","VD Adewoye (NGA)","2019-2019","7","7","1","1","0","0","1","1 (1ct 0st)","0.142"
"759","Aftab Hussain (HKG)","2020-2020","9","9","1","1","0","0","1","1 (1ct 0st)","0.111"
"760","GJ Agius (MLT)","2019-2019","2","2","1","1","0","0","1","1 (1ct 0st)","0.500"
"761","P Agnihotri (NOR)","2019-2019","2","2","1","1","0","0","1","1 (1ct 0st)","0.500"
"762","SA Ahmad (DEN)","2019-2019","5","3","1","1","0","0","1","1 (1ct 0st)","0.333"
"763","Ahmed Hassan (Mald)","2019-2019","11","11","1","1","0","0","1","1 (1ct 0st)","0.090"
"764","Ahsan Malik (NL)","2017-2017","3","3","1","1","0","0","1","1 (1ct 0st)","0.333"
"765","Amar Sharma (MLT)","2020-2020","3","3","1","1","0","0","1","1 (1ct 0st)","0.333"
"766","Aminul Islam (BDESH)","2019-2020","7","7","1","1","0","0","1","1 (1ct 0st)","0.142"
"767","Anam Mollik (ITA)","2019-2019","2","2","1","1","0","0","1","1 (1ct 0st)","0.500"
"768","Anasim Khan (BHR)","2019-2020","8","8","1","1","0","0","1","1 (1ct 0st)","0.125"
"769","Aqib Iqbal (Aut)","2019-2019","5","5","1","1","0","0","1","1 (1ct 0st)","0.200"
"770","S Arachchige (ITA)","2019-2019","4","4","1","1","0","0","1","1 (1ct 0st)","0.250"
"771","Aritra Dutta (SGP)","2019-2019","8","8","1","1","0","0","1","1 (1ct 0st)","0.125"
"772","P Arora (Mex)","2019-2019","2","2","1","1","0","0","1","1 (1ct 0st)","0.500"
"773","Arsalan Arif (Aut)","2019-2019","1","1","1","0","1","0","0","1 (0ct 1st)","1.000"
"774","Arshad Mazarzei (Iran)","2020-2020","3","3","1","1","0","1","0","1 (1ct 0st)","0.333"
"775","U Aryaman Sunil (SGP)","2019-2020","5","5","1","1","0","0","1","1 (1ct 0st)","0.200"
"776","Asad Ali Rehemtulla (BUL)","2020-2020","3","3","1","1","0","0","1","1 (1ct 0st)","0.333"
"777","Ashiqullah Said (Belg)","2019-2020","7","7","1","1","0","0","1","1 (1ct 0st)","0.142"
"778","Aslam Mohammad ()","2019-2019","3","3","1","1","0","0","1","1 (1ct 0st)","0.333"
"779","TD Astle (NZ)","2019-2019","1","1","1","1","0","0","1","1 (1ct 0st)","1.000"
"780","SK Atai (PNG)","2019-2019","2","2","1","1","0","0","1","1 (1ct 0st)","0.500"
"781","V Ateak (Ghana)","2019-2019","4","4","1","1","0","0","1","1 (1ct 0st)","0.250"
"782","Atif Kamal (LUX)","2019-2019","4","4","1","1","0","0","1","1 (1ct 0st)","0.250"
"783","Avi Dixit (SGP)","2019-2019","1","1","1","1","0","0","1","1 (1ct 0st)","1.000"
"784","Babar Hayat (HKG)","2016-2017","4","4","1","1","0","0","1","1 (1ct 0st)","0.250"
"785","MO Bacarese (GIBR)","2019-2019","3","3","1","1","0","0","1","1 (1ct 0st)","0.333"
"786","KS Bagabena (Ghana)","2019-2019","4","4","1","1","0","0","1","1 (1ct 0st)","0.250"
"787","GJ Bailey (AUS/World)","2016-2017","2","2","1","1","0","0","1","1 (1ct 0st)","0.500"
"788","JD Baker (Samoa)","2019-2019","4","4","1","1","0","0","1","1 (1ct 0st)","0.250"
"789","G Bakiweyem (Ghana)","2019-2019","3","3","1","1","0","0","1","1 (1ct 0st)","0.333"
"790","Baljit Singh (ITA)","2019-2019","8","7","1","1","0","0","1","1 (1ct 0st)","0.142"
"791","JT Ball (ENG)","2018-2018","2","2","1","1","0","0","1","1 (1ct 0st)","0.500"
"792","KNA Bandara (SL)","2021-2021","3","3","1","1","0","0","1","1 (1ct 0st)","0.333"
"793","S Bantzas ()","2019-2019","1","1","1","1","0","0","1","1 (1ct 0st)","1.000"
"794","P Baron (Arg)","2019-2019","5","5","1","1","0","0","1","1 (1ct 0st)","0.200"
"795","OO Bascome (BMUDA)","2019-2019","2","2","1","1","0","0","1","1 (1ct 0st)","0.500"
"796","SR Bhudia (KENYA)","2019-2019","4","4","1","1","0","0","1","1 (1ct 0st)","0.250"
"797","D Bishoo (WI)","2019-2019","2","2","1","1","0","0","1","1 (1ct 0st)","0.500"
"798","TA Blundell (NZ)","2017-2018","3","3","1","1","0","1","0","1 (1ct 0st)","0.333"
"799","SM Boland (AUS)","2016-2016","1","1","1","1","0","0","1","1 (1ct 0st)","1.000"
"800","PW Borren (NL)","2017-2017","3","3","1","1","0","0","1","1 (1ct 0st)","0.333"
"801","N Buckle (GUE)","2019-2019","3","3","1","1","0","0","1","1 (1ct 0st)","0.333"
"802","J Bulele (Moz)","2019-2019","7","6","1","1","0","0","1","1 (1ct 0st)","0.166"
"803","DE Burgess (Samoa)","2019-2019","4","4","1","1","0","0","1","1 (1ct 0st)","0.250"
"804","JA Burrows (IOM)","2020-2020","1","1","1","1","0","0","1","1 (1ct 0st)","1.000"
"805","JD Campbell (WI)","2019-2019","2","2","1","1","0","0","1","1 (1ct 0st)","0.500"
"806","PVD Chameera (SL)","2016-2021","11","11","1","1","0","0","1","1 (1ct 0st)","0.090"
"807","P Chandran (Mex)","2019-2019","3","3","1","1","0","0","1","1 (1ct 0st)","0.333"
"808","N Chejay (BHU)","2019-2019","1","1","1","1","0","0","1","1 (1ct 0st)","1.000"
"809","CJ Chibhabha (ZIM)","2016-2020","9","9","1","1","0","0","1","1 (1ct 0st)","0.111"
"810","TS Chisoro (ZIM)","2018-2020","7","7","1","1","0","0","1","1 (1ct 0st)","0.142"
"811","PD Collingwood (World)","2017-2017","1","1","1","1","0","0","1","1 (1ct 0st)","1.000"
"812","M Cope (LUX)","2019-2020","6","6","1","1","0","0","1","1 (1ct 0st)","0.166"
"813","J Cutinho (CRC)","2019-2019","3","3","1","1","0","0","1","1 (1ct 0st)","0.333"
"814","DK Dahani (Iran)","2020-2020","3","3","1","1","0","0","1","1 (1ct 0st)","0.333"
"815","DK Dahyabhai Ahir (PNM)","2019-2019","2","2","1","1","0","0","1","1 (1ct 0st)","0.500"
"816","S Dalton (CZK-R)","2019-2019","2","2","1","1","0","0","1","1 (1ct 0st)","0.500"
"817","H Dandapani (Fin)","2019-2019","5","5","1","1","0","0","1","1 (1ct 0st)","0.200"
"818","CJ Delany (GIBR)","2019-2019","4","4","1","1","0","0","1","1 (1ct 0st)","0.250"
"819","PC de Silva (SL)","2017-2017","2","2","1","1","0","0","1","1 (1ct 0st)","0.500"
"820","S Desungnoen (THAI)","2020-2020","2","2","1","1","0","0","1","1 (1ct 0st)","0.500"
"821","M Dixit (LUX)","2019-2020","5","5","1","1","0","0","1","1 (1ct 0st)","0.200"
"822","LA Dunbar (Serb)","2019-2019","2","2","1","1","0","1","0","1 (1ct 0st)","0.500"
"823","BR Dunk (AUS)","2017-2017","2","2","1","1","0","0","1","1 (1ct 0st)","0.500"
"824","G Dutta (Mex)","2019-2019","7","7","1","1","0","0","1","1 (1ct 0st)","0.142"
"825","GD Elliott (NZ/World)","2016-2017","5","5","1","1","0","0","1","1 (1ct 0st)","0.200"
"826","Emran Shahbakhsh (Iran)","2020-2020","3","3","1","1","0","0","1","1 (1ct 0st)","0.333"
"827","L Evile (Samoa)","2019-2019","4","4","1","1","0","0","1","1 (1ct 0st)","0.250"
"828","M Faheem (THAI)","2019-2020","7","7","1","1","0","0","1","1 (1ct 0st)","0.142"
"829","Fareed Ahmad (AFG)","2016-2021","15","15","1","1","0","0","1","1 (1ct 0st)","0.066"
"830","JA Fitzgerald (GIBR)","2019-2019","4","4","1","1","0","0","1","1 (1ct 0st)","0.250"
"831","BT Foakes (ENG)","2019-2019","1","1","1","1","0","1","0","1 (1ct 0st)","1.000"
"832","BC Fortuin (SA)","2019-2021","6","6","1","1","0","0","1","1 (1ct 0st)","0.166"
"833","TS Fray (BMUDA)","2019-2019","10","10","1","1","0","0","1","1 (1ct 0st)","0.100"
"834","C Fry (LUX)","2019-2019","3","3","1","1","0","0","1","1 (1ct 0st)","0.333"
"835","R Frylinck (SA)","2017-2018","3","3","1","1","0","0","1","1 (1ct 0st)","0.333"
"836","Gershon Yusuf (NGA)","2019-2019","1","1","1","1","0","0","1","1 (1ct 0st)","1.000"
"837","K Gilham (CZK-R)","2020-2020","4","4","1","1","0","0","1","1 (1ct 0st)","0.250"
"838","R Goodwin (PHI)","2019-2019","4","4","1","1","0","0","1","1 (1ct 0st)","0.250"
"839","JOA Gordon (CAN)","2019-2019","5","5","1","1","0","0","1","1 (1ct 0st)","0.200"
"840","K Gore (USA)","2019-2019","4","4","1","1","0","0","1","1 (1ct 0st)","0.250"
"841","S Goud (CZK-R)","2019-2019","1","1","1","1","0","0","1","1 (1ct 0st)","1.000"
"842","Hafez Farooq (Peru)","2019-2019","4","4","1","1","0","0","1","1 (1ct 0st)","0.250"
"843","OJ Hairs (SCOT)","2019-2019","8","8","1","1","0","0","1","1 (1ct 0st)","0.125"
"844","Hamed Khan (HKG)","2020-2020","3","3","1","1","0","0","1","1 (1ct 0st)","0.333"
"845","Hamza Dar (ESP)","2019-2019","1","1","1","1","0","0","1","1 (1ct 0st)","1.000"
"846","Haroon Mughal (MLT)","2019-2020","7","7","1","1","0","0","1","1 (1ct 0st)","0.142"
"847","Hashmatullah Shahidi (AFG)","2021-2021","1","1","1","1","0","0","1","1 (1ct 0st)","1.000"
"848","JW Hastings (AUS)","2016-2016","2","2","1","1","0","0","1","1 (1ct 0st)","0.500"
"849","MJ Henry (NZ)","2017-2017","1","1","1","1","0","0","1","1 (1ct 0st)","1.000"
"850","MG Hunter (GIBR)","2019-2019","4","4","1","1","0","0","1","1 (1ct 0st)","0.250"
"851","JJ Huo (Moz)","2019-2019","7","6","1","1","0","0","1","1 (1ct 0st)","0.166"
"852","J Hurley (Arg)","2019-2019","3","3","1","1","0","0","1","1 (1ct 0st)","0.333"
"853","A Husain (Arg)","2019-2019","5","5","1","1","0","0","1","1 (1ct 0st)","0.200"
"854","GM Hyde (Blz)","2019-2019","3","3","1","1","0","0","1","1 (1ct 0st)","0.333"
"855","Ibrahim Nashath (Mald)","2019-2019","3","3","1","1","0","0","1","1 (1ct 0st)","0.333"
"856","Ibrahim Zadran (AFG)","2019-2019","3","3","1","1","0","0","1","1 (1ct 0st)","0.333"
"857","AF Ifill (Caym)","2019-2019","6","6","1","1","0","0","1","1 (1ct 0st)","0.166"
"858","Ilyas Ahmed (KUW)","2019-2020","7","7","1","1","0","0","1","1 (1ct 0st)","0.142"
"859","Imran Ashraf (QAT)","2019-2020","4","4","1","1","0","0","1","1 (1ct 0st)","0.250"
"860","Imran Butt (BHR)","2020-2020","4","4","1","1","0","0","1","1 (1ct 0st)","0.250"
"861","Imran Haider (UAE)","2016-2019","11","11","1","1","0","0","1","1 (1ct 0st)","0.090"
"862","Jasdeep Singh (USA)","2019-2019","4","4","1","1","0","0","1","1 (1ct 0st)","0.250"
"863","Jaspreet Singh (ITA)","2019-2019","5","4","1","1","0","0","1","1 (1ct 0st)","0.250"
"864","J Jojo (DEN)","2019-2019","7","5","1","1","0","0","1","1 (1ct 0st)","0.200"
"865","MO Jones (BMUDA)","2019-2019","8","8","1","1","0","0","1","1 (1ct 0st)","0.125"
"866","C Jonker (SA)","2018-2018","2","2","1","1","0","0","1","1 (1ct 0st)","0.500"
"867","HJ Jordaan (THAI)","2019-2020","8","8","1","1","0","0","1","1 (1ct 0st)","0.125"
"868","Kaleemullah (OMAN)","2017-2020","8","8","1","1","0","0","1","1 (1ct 0st)","0.125"
"869","Kaleem Shah (Moz)","2019-2019","7","6","1","1","0","0","1","1 (1ct 0st)","0.166"
"870","TS Kamunhukamwe (ZIM)","2020-2021","3","3","1","1","0","0","1","1 (1ct 0st)","0.333"
"871","ST Kanakalil (MLT)","2020-2020","3","3","1","1","0","0","1","1 (1ct 0st)","0.333"
"872","TE Kane (IRE)","2018-2019","2","2","1","1","0","0","1","1 (1ct 0st)","0.500"
"873","Karim Sadiq (AFG)","2018-2018","2","2","1","1","0","0","1","1 (1ct 0st)","0.500"
"874","N Khanna (MLT)","2019-2019","2","2","1","1","0","0","1","1 (1ct 0st)","0.500"
"875","Khizer Ahmed (NOR)","2019-2019","5","5","1","0","1","0","0","1 (0ct 1st)","0.200"
"876","N Khosla (MLT)","2019-2019","4","4","1","1","0","0","1","1 (1ct 0st)","0.250"
"877","Khurram Shahzad (QAT)","2020-2020","7","7","1","1","0","0","1","1 (1ct 0st)","0.142"
"878","TCR Kimber (GUE)","2019-2019","3","3","1","0","1","0","0","1 (0ct 1st)","0.333"
"879","NR Kirton (CAN)","2019-2019","5","5","1","1","0","0","1","1 (1ct 0st)","0.200"
"880","HG Kuhn (SA)","2017-2017","2","2","1","1","0","0","1","1 (1ct 0st)","0.500"
"881","Kuldeep Singh (PHI)","2019-2019","4","4","1","1","0","0","1","1 (1ct 0st)","0.250"
"882","R Kumar (ROM)","2019-2019","4","4","1","1","0","0","1","1 (1ct 0st)","0.250"
"883","Kushal Malla (NEPAL)","2019-2020","6","6","1","1","0","0","1","1 (1ct 0st)","0.166"
"884","A Lagos ()","2019-2019","1","1","1","1","0","0","1","1 (1ct 0st)","1.000"
"885","RAS Lakmal (SL)","2016-2019","6","6","1","1","0","0","1","1 (1ct 0st)","0.166"
"886","H Lakov (BUL)","2019-2020","6","5","1","1","0","0","1","1 (1ct 0st)","0.200"
"887","GF Linde (SA)","2020-2020","3","3","1","1","0","0","1","1 (1ct 0st)","0.333"
"888","I Liyanage (QAT)","2020-2020","7","7","1","1","0","0","1","1 (1ct 0st)","0.142"
"889","NCK Liyanage (MAL)","2019-2019","6","5","1","1","0","0","1","1 (1ct 0st)","0.200"
"890","J Long (PHI)","2019-2019","2","2","1","1","0","0","1","1 (1ct 0st)","0.500"
"891","T Lungameni (NAM)","2019-2019","6","6","1","1","0","0","1","1 (1ct 0st)","0.166"
"892","CA Lynn (AUS)","2018-2018","13","12","1","1","0","0","1","1 (1ct 0st)","0.083"
"893","NL McCullum (NZ)","2016-2016","1","1","1","1","0","0","1","1 (1ct 0st)","1.000"
"894","NJ Maddinson (AUS)","2018-2018","4","4","1","1","0","0","1","1 (1ct 0st)","0.250"
"895","Mahedi Hasan (BDESH)","2018-2020","4","4","1","1","0","0","1","1 (1ct 0st)","0.250"
"896","Mahmad Data (PNM)","2019-2019","2","2","1","1","0","0","1","1 (1ct 0st)","0.500"
"897","S Mahmood (ENG)","2019-2020","6","5","1","1","0","0","1","1 (1ct 0st)","0.200"
"898","BF Mailata (Samoa)","2019-2019","4","4","1","1","0","0","1","1 (1ct 0st)","0.250"
"899","D Maisuria (Botsw)","2019-2019","6","6","1","1","0","0","1","1 (1ct 0st)","0.166"
"900","A Makesh (KUW)","2019-2019","4","4","1","1","0","0","1","1 (1ct 0st)","0.250"
"901","P Malav (LUX)","2020-2020","3","3","1","1","0","0","1","1 (1ct 0st)","0.333"
"902","Mandeep Singh (INDIA)","2016-2016","3","3","1","1","0","0","1","1 (1ct 0st)","0.333"
"903","P Manning (Caym)","2019-2019","6","6","1","1","0","0","1","1 (1ct 0st)","0.166"
"904","AK Markram (SA)","2019-2019","2","2","1","1","0","0","1","1 (1ct 0st)","0.500"
"905","OM Marshall (Peru)","2019-2019","3","3","1","1","0","0","1","1 (1ct 0st)","0.333"
"906","XM Marshall (USA)","2019-2019","7","7","1","1","0","0","1","1 (1ct 0st)","0.142"
"907","Mashrafe Mortaza (BDESH)","2016-2017","8","8","1","1","0","0","1","1 (1ct 0st)","0.125"
"908","I Master (Botsw)","2019-2019","2","2","1","1","0","0","1","1 (1ct 0st)","0.500"
"909","M Meade (Chile)","2019-2019","1","1","1","1","0","0","1","1 (1ct 0st)","1.000"
"910","NSK Mehta (Belg)","2020-2020","4","4","1","1","0","0","1","1 (1ct 0st)","0.250"
"911","PHKD Mendis (SL)","2018-2019","4","4","1","1","0","0","1","1 (1ct 0st)","0.250"
"912","K Mendon (CZK-R)","2019-2020","11","11","1","1","0","0","1","1 (1ct 0st)","0.090"
"913","CAJ Meschede (GER)","2019-2019","5","5","1","1","0","0","1","1 (1ct 0st)","0.200"
"914","Mian Mehmood (PORT)","2019-2019","4","4","1","1","0","0","1","1 (1ct 0st)","0.250"
"915","AJ Michael (Samoa)","2019-2019","4","4","1","1","0","0","1","1 (1ct 0st)","0.250"
"916","TS Mills (ENG/ICC)","2016-2018","5","5","1","1","0","0","1","1 (1ct 0st)","0.200"
"917","AF Milne (NZ)","2016-2018","6","6","1","1","0","0","1","1 (1ct 0st)","0.166"
"918","A Mishra (INDIA)","2016-2017","3","3","1","1","0","0","1","1 (1ct 0st)","0.333"
"919","K Modise (Botsw)","2019-2019","3","3","1","1","0","0","1","1 (1ct 0st)","0.333"
"920","Mohammad Mithun (BDESH)","2016-2020","6","6","1","1","0","0","1","1 (1ct 0st)","0.166"
"921","Mohammad Sami (PAK)","2016-2016","3","3","1","1","0","0","1","1 (1ct 0st)","0.333"
"922","JN Mohammed (WI)","2017-2018","9","9","1","1","0","0","1","1 (1ct 0st)","0.111"
"923","Mohammed Qasim (UAE)","2016-2017","3","3","1","1","0","0","1","1 (1ct 0st)","0.333"
"924","Mohammed Siraj (INDIA)","2017-2018","3","3","1","1","0","0","1","1 (1ct 0st)","0.333"
"925","M Mooketsi (Botsw)","2019-2019","7","7","1","1","0","0","1","1 (1ct 0st)","0.142"
"926","Mudassar Muhammad (GER)","2019-2019","7","7","1","1","0","0","1","1 (1ct 0st)","0.142"
"927","Muhamad Syahadat (MAL)","2019-2019","10","9","1","1","0","0","1","1 (1ct 0st)","0.111"
"928","Muhammad Amir (MAL)","2019-2019","1","1","1","1","0","0","1","1 (1ct 0st)","1.000"
"929","Muhammad Asjed (ESP)","2019-2019","2","2","1","1","0","0","1","1 (1ct 0st)","0.500"
"930","Muhammad Khurram (MWI)","2019-2019","5","5","1","1","0","1","0","1 (1ct 0st)","0.200"
"931","Muhammad Naeem (Saudi)","2019-2020","7","7","1","1","0","0","1","1 (1ct 0st)","0.142"
"932","Muhammad Saleem ()","2019-2019","4","4","1","1","0","0","1","1 (1ct 0st)","0.250"
"933","AK Muslar (Blz)","2019-2019","3","3","1","1","0","0","1","1 (1ct 0st)","0.333"
"934","M Mwamadi (MWI)","2019-2019","3","3","1","1","0","0","1","1 (1ct 0st)","0.333"
"935","SJ Myburgh (NL)","2017-2019","6","6","1","1","0","0","1","1 (1ct 0st)","0.166"
"936","S Nadigotla (ROM)","2019-2020","3","3","1","1","0","1","0","1 (1ct 0st)","0.333"
"937","Najjam Shahzad (PORT)","2019-2019","4","4","1","1","0","0","1","1 (1ct 0st)","0.250"
"938","DM Nakrani (UGA)","2019-2019","4","4","1","1","0","0","1","1 (1ct 0st)","0.250"
"939","W Nalisa (VAN)","2019-2019","9","9","1","1","0","0","1","1 (1ct 0st)","0.111"
"940","A Nathwani (Aut)","2019-2019","5","5","1","1","0","0","1","1 (1ct 0st)","0.200"
"941","A Natubhai Ahir (PNM)","2019-2019","3","3","1","1","0","0","1","1 (1ct 0st)","0.333"
"942","Nawroz Mangal (AFG)","2017-2017","2","2","1","1","0","0","1","1 (1ct 0st)","0.500"
"943","Nazakat Ali (NOR)","2019-2019","2","2","1","1","0","0","1","1 (1ct 0st)","0.500"
"944","P Nissanka (SL)","2021-2021","3","3","1","1","0","0","1","1 (1ct 0st)","0.333"
"945","L Nussbaumer (GUE)","2019-2019","1","1","1","1","0","0","1","1 (1ct 0st)","1.000"
"946","AA Obanda (KENYA)","2019-2019","6","6","1","1","0","0","1","1 (1ct 0st)","0.166"
"947","SH Obed (VAN)","2019-2019","12","12","1","1","0","0","1","1 (1ct 0st)","0.083"
"948","E Ochieng (KENYA)","2019-2019","2","2","1","1","0","0","1","1 (1ct 0st)","0.500"
"949","IO Okpe (NGA)","2019-2019","8","8","1","1","0","0","1","1 (1ct 0st)","0.125"
"950","R Olipa (UGA)","2019-2019","2","2","1","1","0","0","1","1 (1ct 0st)","0.500"
"951","Omar Hayat (DEN)","2019-2019","2","2","1","1","0","0","1","1 (1ct 0st)","0.500"
"952","E Otieno (KENYA)","2019-2019","8","8","1","1","0","0","1","1 (1ct 0st)","0.125"
"953","A Otwani (UGA)","2019-2020","7","7","1","1","0","1","0","1 (1ct 0st)","0.142"
"954","E Packard (GIBR)","2019-2019","4","4","1","1","0","0","1","1 (1ct 0st)","0.250"
"955","I Pandey (NEPAL)","2019-2019","4","4","1","1","0","0","1","1 (1ct 0st)","0.250"
"956","NMS Param (SGP)","2019-2019","8","8","1","1","0","0","1","1 (1ct 0st)","0.125"
"957","WD Parnell (SA)","2017-2017","5","5","1","1","0","0","1","1 (1ct 0st)","0.200"
"958","RN Patel (KENYA)","2019-2019","2","2","1","1","0","0","1","1 (1ct 0st)","0.500"
"959","D Paterson (SA)","2017-2018","8","8","1","1","0","0","1","1 (1ct 0st)","0.125"
"960","C Pengkumta (THAI)","2019-2020","5","5","1","1","0","0","1","1 (1ct 0st)","0.200"
"961","SL Perera (Ghana)","2019-2019","2","2","1","1","0","0","1","1 (1ct 0st)","0.500"
"962","J Perman (ESP)","2019-2020","4","4","1","1","0","0","1","1 (1ct 0st)","0.250"
"963","R Pillai (GER)","2019-2019","6","6","1","1","0","0","1","1 (1ct 0st)","0.166"
"964","R Pisal (ROM)","2019-2019","1","1","1","1","0","0","1","1 (1ct 0st)","1.000"
"965","S Pokhriyal (CZK-R)","2019-2020","9","9","1","1","0","0","1","1 (1ct 0st)","0.111"
"966","Raja Adeel (ESP)","2019-2020","5","5","1","1","0","0","1","1 (1ct 0st)","0.200"
"967","A Rangaswamy (Botsw)","2019-2019","4","4","1","1","0","0","1","1 (1ct 0st)","0.250"
"968","Raza Iqbal (NOR)","2019-2019","5","5","1","1","0","0","1","1 (1ct 0st)","0.200"
"969","JB Reva (PNG)","2017-2019","6","6","1","1","0","0","1","1 (1ct 0st)","0.166"
"970","MJG Rippon (NL)","2017-2018","4","3","1","1","0","0","1","1 (1ct 0st)","0.333"
"971","Rumman Raees (PAK)","2016-2018","8","8","1","1","0","0","1","1 (1ct 0st)","0.125"
"972","GR Russ (PHI)","2019-2019","3","3","1","1","0","0","1","1 (1ct 0st)","0.333"
"973","SE Rutherford (WI)","2018-2020","6","6","1","1","0","0","1","1 (1ct 0st)","0.166"
"974","VM Sachdev (PNM)","2019-2019","2","2","1","1","0","0","1","1 (1ct 0st)","0.500"
"975","Sadeeq Khan (ROM)","2019-2019","3","3","1","1","0","0","1","1 (1ct 0st)","0.333"
"976","Sahir Naqash (GER)","2019-2020","8","8","1","1","0","0","1","1 (1ct 0st)","0.125"
"977","JRMVB Sanjaya (SL)","2017-2017","8","8","1","1","0","0","1","1 (1ct 0st)","0.125"
"978","Saqlain Arshad (QAT)","2019-2019","2","2","1","1","0","0","1","1 (1ct 0st)","0.500"
"979","M Sarenac (Serb)","2019-2019","2","2","1","1","0","0","1","1 (1ct 0st)","0.500"
"980","A Sarma (GER)","2019-2020","4","4","1","1","0","0","1","1 (1ct 0st)","0.250"
"981","MM Sarwar (KUW)","2019-2019","5","5","1","1","0","0","1","1 (1ct 0st)","0.200"
"982","I Sawmy (DEN)","2019-2019","2","2","1","1","0","0","1","1 (1ct 0st)","0.500"
"983","Shaffeq Muhammad ()","2019-2019","2","2","1","1","0","0","1","1 (1ct 0st)","0.500"
"984","Shaheen Shah Afridi (PAK)","2018-2021","21","21","1","1","0","0","1","1 (1ct 0st)","0.047"
"985","Shahid Afridi (ICC/PAK)","2016-2018","4","4","1","1","0","0","1","1 (1ct 0st)","0.250"
"986","Shamsudheen Purat (Saudi)","2019-2020","6","6","1","1","0","0","1","1 (1ct 0st)","0.166"
"987","A Sharafu (UAE)","2020-2020","5","5","1","1","0","0","1","1 (1ct 0st)","0.200"
"988","Sharafuddin Ashraf (AFG)","2018-2019","4","4","1","1","0","0","1","1 (1ct 0st)","0.250"
"989","Sharjeel Khan (PAK)","2016-2016","7","7","1","1","0","0","1","1 (1ct 0st)","0.142"
"990","R Shepherd (WI)","2020-2020","3","2","1","1","0","0","1","1 (1ct 0st)","0.500"
"991","Shuvagata Hom (BDESH)","2016-2016","3","3","1","1","0","0","1","1 (1ct 0st)","0.333"
"992","KRP Silva (USA)","2019-2019","2","2","1","1","0","0","1","1 (1ct 0st)","0.500"
"993","M Simpson-Parker (Aut)","2019-2019","3","3","1","1","0","0","1","1 (1ct 0st)","0.333"
"994","J Singye (BHU)","2019-2019","2","2","1","1","0","0","1","1 (1ct 0st)","0.500"
"995","JT Smuts (SA)","2017-2021","13","13","1","1","0","0","1","1 (1ct 0st)","0.076"
"996","GJ Snyman (SA)","2021-2021","1","1","1","1","0","0","1","1 (1ct 0st)","1.000"
"997","CB Sole (SCOT)","2017-2018","4","4","1","1","0","0","1","1 (1ct 0st)","0.250"
"998","CA Soper (PNG)","2017-2019","10","10","1","1","0","0","1","1 (1ct 0st)","0.100"
"999","A Srivastav (Chile)","2019-2019","4","4","1","1","0","0","1","1 (1ct 0st)","0.250"
"1000","SSM Stanislaus (MLT)","2020-2020","3","3","1","1","0","0","1","1 (1ct 0st)","0.333"
"1001","DW Steyn (SA)","2016-2020","7","7","1","1","0","0","1","1 (1ct 0st)","0.142"
"1002","ACF Stokes (GUE)","2019-2020","8","8","1","1","0","0","1","1 (1ct 0st)","0.125"
"1003","Sulaiman Ali (BUL)","2020-2020","6","6","1","1","0","0","1","1 (1ct 0st)","0.166"
"1004","P Syafiq Ali (MAL)","2019-2019","2","1","1","1","0","0","1","1 (1ct 0st)","1.000"
"1005","Tanveer Ahmed (HKG)","2016-2017","4","4","1","1","0","0","1","1 (1ct 0st)","0.250"
"1006","Tanwir Afzal (HKG)","2016-2016","1","1","1","1","0","0","1","1 (1ct 0st)","1.000"
"1007","P Taylor (CZK-R)","2019-2019","7","7","1","1","0","0","1","1 (1ct 0st)","0.142"
"1008","T Taylor (Caym)","2019-2019","6","6","1","1","0","0","1","1 (1ct 0st)","0.166"
"1009","RN ten Doeschate (NL)","2018-2019","13","12","1","1","0","0","1","1 (1ct 0st)","0.083"
"1010","SP Terry (IRE)","2016-2016","1","1","1","1","0","0","1","1 (1ct 0st)","1.000"
"1011","VP Thamotharam (MLT)","2020-2020","2","2","1","1","0","0","1","1 (1ct 0st)","0.500"
"1012","WU Tharanga (SL)","2017-2018","16","16","1","1","0","0","1","1 (1ct 0st)","0.062"
"1013","HDRL Thirimanne (SL)","2016-2016","3","3","1","1","0","0","1","1 (1ct 0st)","0.333"
"1014","O Thomas (WI)","2018-2020","15","14","1","1","0","0","1","1 (1ct 0st)","0.071"
"1015","BM Tickner (NZ)","2019-2020","6","6","1","1","0","0","1","1 (1ct 0st)","0.166"
"1016","S Tobgay (BHU)","2019-2019","2","2","1","1","0","0","1","1 (1ct 0st)","0.500"
"1017","A Tripathi (Mex)","2019-2019","3","3","1","1","0","0","1","1 (1ct 0st)","0.333"
"1018","JJ Tucker (BMUDA)","2019-2019","5","5","1","1","0","0","1","1 (1ct 0st)","0.200"
"1019","W Uisuk (THAI)","2020-2020","4","4","1","1","0","0","1","1 (1ct 0st)","0.250"
"1020","Umar Amin (PAK)","2017-2018","4","4","1","1","0","0","1","1 (1ct 0st)","0.250"
"1021","A Uniyal (Chile)","2019-2019","3","3","1","1","0","0","1","1 (1ct 0st)","0.333"
"1022","Usama Master (MWI)","2019-2019","6","6","1","1","0","0","1","1 (1ct 0st)","0.166"
"1023","Usman Ali (Saudi)","2019-2020","8","8","1","1","0","0","1","1 (1ct 0st)","0.125"
"1024","Usman Qadir (PAK)","2020-2021","6","6","1","1","0","0","1","1 (1ct 0st)","0.166"
"1025","Usman Waheed (KUW)","2019-2019","6","6","1","1","0","0","1","1 (1ct 0st)","0.166"
"1026","PJ van Biljon (SA)","2020-2021","7","7","1","1","0","0","1","1 (1ct 0st)","0.142"
"1027","TCW Veillard (GUE)","2019-2019","4","4","1","1","0","0","1","1 (1ct 0st)","0.250"
"1028","S Vijayakumar (SGP)","2019-2019","9","9","1","1","0","0","1","1 (1ct 0st)","0.111"
"1029","Vimal Kumar (PHI)","2019-2019","2","2","1","1","0","0","1","1 (1ct 0st)","0.500"
"1030","W Viraliliu (VAN)","2019-2019","10","10","1","1","0","0","1","1 (1ct 0st)","0.100"
"1031","Vishal Ahir (PNM)","2019-2019","1","1","1","1","0","0","1","1 (1ct 0st)","1.000"
"1032","Wahidullah Usmani (Belg)","2020-2020","4","4","1","1","0","0","1","1 (1ct 0st)","0.250"
"1033","K Waiswa (UGA)","2020-2020","3","3","1","1","0","0","1","1 (1ct 0st)","0.333"
"1034","MN Waller (ZIM)","2016-2018","7","7","1","1","0","0","1","1 (1ct 0st)","0.142"
"1035","Waqar Khan (Peru)","2019-2019","4","4","1","1","0","0","1","1 (1ct 0st)","0.250"
"1036","Waqas Ali (Belg)","2019-2019","2","2","1","1","0","0","1","1 (1ct 0st)","0.500"
"1037","Waqas Khan (HKG)","2017-2020","11","11","1","1","0","0","1","1 (1ct 0st)","0.090"
"1038","AA Westphal (Mex)","2019-2019","5","5","1","1","0","0","1","1 (1ct 0st)","0.200"
"1039","BTJ Wheal (SCOT)","2017-2017","3","3","1","1","0","0","1","1 (1ct 0st)","0.333"
"1040","BM Wheeler (NZ)","2017-2018","6","6","1","1","0","0","1","1 (1ct 0st)","0.166"
"1041","T Whiteman (LUX)","2019-2020","8","8","1","1","0","0","1","1 (1ct 0st)","0.125"
"1042","S Wickramasekara (CZK-R)","2019-2020","9","9","1","1","0","0","1","1 (1ct 0st)","0.111"
"1043","SA Wijeyeratne (CAN)","2019-2019","2","2","1","1","0","0","1","1 (1ct 0st)","0.500"
"1044","JD Wildermuth (AUS)","2018-2018","2","2","1","1","0","0","1","1 (1ct 0st)","0.500"
"1045","AS Wright (GUE)","2019-2019","8","8","1","1","0","0","1","1 (1ct 0st)","0.125"
"1046","SA Yadav (INDIA)","2021-2021","2","1","1","1","0","0","1","1 (1ct 0st)","1.000"
"1047","HN Ya France (NAM)","2019-2019","6","6","1","1","0","0","1","1 (1ct 0st)","0.166"
"1048","Yasar Idrees (KUW)","2019-2019","1","1","1","1","0","0","1","1 (1ct 0st)","1.000"
"1049","Zameer Khan (DEN)","2019-2019","2","2","1","1","0","0","1","1 (1ct 0st)","0.500"
"1050","C Zavoiu (ROM)","2019-2020","7","7","1","1","0","0","1","1 (1ct 0st)","0.142"
"1051","Zawar Farid (UAE)","2019-2019","4","4","1","1","0","0","1","1 (1ct 0st)","0.250"
"1052","Zeeshan Abbas (BHR)","2019-2019","1","1","1","1","0","0","1","1 (1ct 0st)","1.000"
"1053","C Zhuwao (ZIM)","2018-2018","2","2","1","1","0","0","1","1 (1ct 0st)","0.500"
"1054","Zubaidi Zulkifle (MAL)","2019-2019","4","4","1","1","0","0","1","1 (1ct 0st)","0.250"
"1055","Zulqarnain Haider (ESP)","2019-2019","5","5","1","1","0","0","1","1 (1ct 0st)","0.200"
"1056","ME Sanuth (OMAN)","2020-2020","1","1","0","0","0","0","0","0","0.000"
"1057","Aamer Ikram (PORT)","2019-2019","4","4","0","0","0","0","0","0","0.000"
"1058","Aamer Yamin (PAK)","2018-2018","1","1","0","0","0","0","0","0","0.000"
"1059","Aaron Jones (USA)","2019-2019","8","8","0","0","0","0","0","0","0.000"
"1060","Z Abbasi (Botsw)","2019-2019","1","1","0","0","0","0","0","0","0.000"
"1061","Abbas Saad (Saudi)","2019-2019","2","2","0","0","0","0","0","0","0.000"
"1062","KJ Abbott (SA)","2016-2016","3","3","0","0","0","0","0","0","0.000"
"1063","Abdullah Mahmood (DEN)","2019-2019","1","1","0","0","0","0","0","0","0.000"
"1064","Abdullah Shafique (PAK)","2020-2020","3","3","0","0","0","0","0","0","0.000"
"1065","Abdullah Sheikh (NOR)","2019-2019","2","2","0","0","0","0","0","0","0.000"
"1066","Abdul Majid (BHR)","2020-2020","4","4","0","0","0","0","0","0","0.000"
"1067","Abdul Rahman (Aut)","2019-2019","3","3","0","0","0","0","0","0","0.000"
"1068","Abdul Rashid (Belg)","2019-2019","1","1","0","0","0","0","0","0","0.000"
"1069","M Aboagye (Ghana)","2019-2019","3","3","0","0","0","0","0","0","0.000"
"1070","RA Abolarin (NGA)","2019-2019","1","1","0","0","0","0","0","0","0.000"
"1071","Abul Hasan (BDESH)","2018-2018","1","1","0","0","0","0","0","0","0.000"
"1072","Adel Kolasangiani (Iran)","2020-2020","1","1","0","0","0","0","0","0","0.000"
"1073","Adil Hanif (BHR)","2019-2019","4","4","0","0","0","0","0","0","0.000"
"1074","Adnan Mufti (UAE)","2017-2017","1","1","0","0","0","0","0","0","0.000"
"1075","N Advani (GIBR)","2019-2019","1","1","0","0","0","0","0","0","0.000"
"1076","Aftab Ahmed (2) (DEN)","2019-2019","1","1","0","0","0","0","0","0","0.000"
"1077","Aftab Kayani (ROM)","2020-2020","1","1","0","0","0","0","0","0","0.000"
"1078","A Ahmadhel (BUL)","2019-2020","6","6","0","0","0","0","0","0","0.000"
"1079","Ahmed Raid (Mald)","2020-2020","1","1","0","0","0","0","0","0","0.000"
"1080","Ahmed Wardak (GER)","2019-2020","10","10","0","0","0","0","0","0","0.000"
"1081","Ahsan Abbasi (HKG)","2019-2019","6","6","0","0","0","0","0","0","0.000"
"1082","Ahsan Ali (PAK)","2020-2020","2","2","0","0","0","0","0","0","0.000"
"1083","Ainool Hafizs (MAL)","2019-2019","3","3","0","0","0","0","0","0","0.000"
"1084","D Ajekun (NGA)","2019-2019","6","6","0","0","0","0","0","0","0.000"
"1085","F Akankwasa (UGA)","2020-2020","3","3","0","0","0","0","0","0","0.000"
"1086","NN Akhter (MLT)","2020-2020","3","3","0","0","0","0","0","0","0.000"
"1087","C Akyuz (TKY)","2019-2019","1","1","0","0","0","0","0","0","0.000"
"1088","Ali Ivan (Mald)","2019-2019","1","1","0","0","0","0","0","0","0.000"
"1089","Ali Abbas (Saudi)","2020-2020","1","1","0","0","0","0","0","0","0.000"
"1090","Ali Naqi (PORT)","2019-2019","4","4","0","0","0","0","0","0","0.000"
"1091","Ali Mohammadipour (Iran)","2020-2020","3","3","0","0","0","0","0","0","0.000"
"1092","J Allen ()","2019-2019","2","2","0","0","0","0","0","0","0.000"
"1093","HS Alta (TKY)","2019-2019","4","4","0","0","0","0","0","0","0.000"
"1094","Ameel Mauroof (Mald)","2019-2020","13","13","0","0","0","0","0","0","0.000"
"1095","Ameer Saiyed (Botsw)","2019-2019","4","4","0","0","0","0","0","0","0.000"
"1096","Amir Hayat (UAE)","2018-2019","4","4","0","0","0","0","0","0","0.000"
"1097","Amir Hamza (AFG)","2016-2021","16","16","0","0","0","0","0","0","0.000"
"1098","Ammad Uddin (BHR)","2019-2020","8","8","0","0","0","0","0","0","0.000"
"1099","DK Anefie (Ghana)","2019-2019","4","4","0","0","0","0","0","0","0.000"
"1100","A Anemogiannis ()","2019-2019","1","1","0","0","0","0","0","0","0.000"
"1101","B Angeltti (Arg)","2019-2019","3","3","0","0","0","0","0","0","0.000"
"1102","DNA Ankrah (Ghana)","2019-2019","4","4","0","0","0","0","0","0","0.000"
"1103","Ansar Iqbal (NOR)","2019-2019","4","4","0","0","0","0","0","0","0.000"
"1104","MJ Ansell (IOM)","2020-2020","1","1","0","0","0","0","0","0","0.000"
"1105","MA Aponso (SL)","2018-2018","3","3","0","0","0","0","0","0","0.000"
"1106","Apon Mustafizur (Serb)","2019-2019","2","2","0","0","0","0","0","0","0.000"
"1107","S Appu (MLT)","2019-2019","4","4","0","0","0","0","0","0","0.000"
"1108","Z Arinaitwe (UGA)","2019-2020","6","6","0","0","0","0","0","0","0.000"
"1109","B Arora (MLT)","2019-2019","4","4","0","0","0","0","0","0","0.000"
"1110","Arshad Hayat (CZK-R)","2019-2019","7","7","0","0","0","0","0","0","0.000"
"1111","Arslan Ahmed (PORT)","2019-2019","3","3","0","0","0","0","0","0","0.000"
"1112","Arslan Ahmed ()","2019-2019","3","3","0","0","0","0","0","0","0.000"
"1113","Asif Bevinje (ROM)","2020-2020","3","3","0","0","0","0","0","0","0.000"
"1114","A Aspiotis ()","2019-2019","3","3","0","0","0","0","0","0","0.000"
"1115","S Ateak (Ghana)","2019-2019","3","3","0","0","0","0","0","0","0.000"
"1116","Atif Ali Khan (UAE)","2016-2016","1","1","0","0","0","0","0","0","0.000"
"1117","Atif Mehmood (ESP)","2019-2019","9","9","0","0","0","0","0","0","0.000"
"1118","R Avery ()","2019-2019","4","4","0","0","0","0","0","0","0.000"
"1119","Aziz Mohammad (Belg)","2019-2019","3","3","0","0","0","0","0","0","0.000"
"1120","Azyan Farhath (Mald)","2019-2019","2","2","0","0","0","0","0","0","0.000"
"1121","Bakhtiar Tahiri (BUL)","2020-2020","7","6","0","0","0","0","0","0","0.000"
"1122","R Bakum (Ghana)","2019-2019","4","4","0","0","0","0","0","0","0.000"
"1123","KMC Bandara (SL)","2016-2016","1","1","0","0","0","0","0","0","0.000"
"1124","HH Banner (Blz)","2019-2019","3","3","0","0","0","0","0","0","0.000"
"1125","TC Barker (LUX)","2019-2019","4","4","0","0","0","0","0","0","0.000"
"1126","Bashir Shah (DEN)","2019-2019","4","4","0","0","0","0","0","0","0.000"
"1127","D Bau (PNG)","2017-2017","1","1","0","0","0","0","0","0","0.000"
"1128","HK Bennett (NZ)","2020-2020","7","7","0","0","0","0","0","0","0.000"
"1129","SVE Bharathi (GER)","2020-2020","2","2","0","0","0","0","0","0","0.000"
"1130","P Bharat Patel (PNM)","2019-2019","2","2","0","0","0","0","0","0","0.000"
"1131","S Bhari (NEPAL)","2019-2020","8","8","0","0","0","0","0","0","0.000"
"1132","P Bhart (NOR)","2019-2019","5","5","0","0","0","0","0","0","0.000"
"1133","LT Bichard (GUE)","2020-2020","1","1","0","0","0","0","0","0","0.000"
"1134","Bilal Ahmed (Serb)","2019-2019","1","1","0","0","0","0","0","0","0.000"
"1135","STR Binny (INDIA)","2016-2016","1","1","0","0","0","0","0","0","0.000"
"1136","K Birkenstock (NAM)","2019-2019","4","4","0","0","0","0","0","0","0.000"
"1137","KK Bishnoi ()","2019-2019","3","3","0","0","0","0","0","0","0.000"
"1138","CC Blake (VAN)","2019-2019","3","3","0","0","0","0","0","0","0.000"
"1139","TS Braat (NL)","2019-2019","3","3","0","0","0","0","0","0","0.000"
"1140","DL Brangman (BMUDA)","2019-2019","5","5","0","0","0","0","0","0","0.000"
"1141","M Breban (GUE)","2020-2020","1","1","0","0","0","0","0","0","0.000"
"1142","NT Broom (NZ)","2017-2017","1","1","0","0","0","0","0","0","0.000"
"1143","P Buccimazza (PORT)","2019-2019","4","4","0","0","0","0","0","0","0.000"
"1144","T Bukenya (UGA)","2020-2020","3","3","0","0","0","0","0","0","0.000"
"1145","A Bulow (DEN)","2019-2019","2","1","0","0","0","0","0","0","0.000"
"1146","G Burrows (IOM)","2020-2020","1","1","0","0","0","0","0","0","0.000"
"1147","J Butler (IOM)","2020-2020","1","1","0","0","0","0","0","0","0.000"
"1148","S Byrne (MLT)","2019-2019","2","2","0","0","0","0","0","0","0.000"
"1149","G Caisley ()","2019-2019","4","4","0","0","0","0","0","0","0.000"
"1150","HL Carlyon (JER)","2019-2019","9","9","0","0","0","0","0","0","0.000"
"1151","A Carthew (Chile)","2019-2019","4","4","0","0","0","0","0","0","0.000"
"1152","T Caruana (GIBR)","2019-2019","2","2","0","0","0","0","0","0","0.000"
"1153","D Cato (Caym)","2019-2019","3","3","0","0","0","0","0","0","0.000"
"1154","DL Chahar (INDIA)","2018-2020","13","13","0","0","0","0","0","0","0.000"
"1155","RD Chahar (INDIA)","2019-2021","2","1","0","0","0","0","0","0","0.000"
"1156","Charanjeet Singh (ITA)","2019-2019","3","2","0","0","0","0","0","0","0.000"
"1157","M Chauhan (Fin)","2019-2019","2","2","0","0","0","0","0","0","0.000"
"1158","VB Chikkannaiah (GER)","2019-2020","9","9","0","0","0","0","0","0","0.000"
"1159","Chirag Suri (UAE)","2018-2020","12","12","0","0","0","0","0","0","0.000"
"1160","S Chophel (BHU)","2019-2019","1","1","0","0","0","0","0","0","0.000"
"1161","DT Christian (AUS)","2017-2017","1","1","0","0","0","0","0","0","0.000"
"1162","I Civric (Serb)","2019-2019","1","1","0","0","0","0","0","0","0.000"
"1163","GL Cloete (SA)","2018-2019","2","2","0","0","0","0","0","0","0.000"
"1164","NG Collins (Fin)","2019-2019","5","5","0","0","0","0","0","0","0.000"
"1165","MNR Cooray (Mald)","2019-2020","7","7","0","0","0","0","0","0","0.000"
"1166","SJ Cotter (Samoa)","2019-2019","4","4","0","0","0","0","0","0","0.000"
"1167","MS Crane (ENG)","2017-2017","2","2","0","0","0","0","0","0","0.000"
"1168","AG Cremer (ZIM)","2016-2018","5","5","0","0","0","0","0","0","0.000"
"1169","SM Curran (ENG)","2019-2021","12","12","0","0","0","0","0","0","0.000"
"1170","BCJ Cutting (World)","2017-2017","3","3","0","0","0","0","0","0","0.000"
"1171","MD Dai (PNG)","2017-2017","3","3","0","0","0","0","0","0","0.000"
"1172","H Dajc (Serb)","2019-2019","2","2","0","0","0","0","0","0","0.000"
"1173","IDA Damarell (GUE)","2020-2020","1","1","0","0","0","0","0","0","0.000"
"1174","I Danladi (NGA)","2019-2019","3","3","0","0","0","0","0","0","0.000"
"1175","Dawlat Zadran (AFG)","2016-2019","6","6","0","0","0","0","0","0","0.000"
"1176","DC Delany (IRE)","2019-2019","8","8","0","0","0","0","0","0","0.000"
"1177","D de la Puente (Peru)","2019-2019","2","2","0","0","0","0","0","0","0.000"
"1178","IA De Silva (BUL)","2020-2020","6","5","0","0","0","0","0","0","0.000"
"1179","ST de Silva (SL)","2017-2017","3","3","0","0","0","0","0","0","0.000"
"1180","V Dikov (BUL)","2019-2019","3","3","0","0","0","0","0","0","0.000"
"1181","TM Dilshan (SL)","2016-2016","5","5","0","0","0","0","0","0","0.000"
"1182","SDJJ Dima (Moz)","2019-2019","4","3","0","0","0","0","0","0","0.000"
"1183","N Dipakkumar Patel (PNM)","2019-2019","3","3","0","0","0","0","0","0","0.000"
"1184","A Djorovic (Serb)","2019-2019","2","2","0","0","0","0","0","0","0.000"
"1185","JN Dorji (BHU)","2019-2019","1","1","0","0","0","0","0","0","0.000"
"1186","K Dorji (BHU)","2019-2019","2","2","0","0","0","0","0","0","0.000"
"1187","RM Dorji (BHU)","2019-2019","1","1","0","0","0","0","0","0","0.000"
"1188","U Dorji (BHU)","2019-2019","2","2","0","0","0","0","0","0","0.000"
"1189","BM Duckett (ENG)","2019-2019","1","1","0","0","0","0","0","0","0.000"
"1190","JA Duffy (NZ)","2020-2020","1","1","0","0","0","0","0","0","0.000"
"1191","B Dugic (Serb)","2019-2019","2","2","0","0","0","0","0","0","0.000"
"1192","J Dunn (VAN)","2019-2019","4","4","0","0","0","0","0","0","0.000"
"1193","KR Ebanks (Caym)","2019-2019","5","5","0","0","0","0","0","0","0.000"
"1194","FH Edwards (WI)","2021-2021","2","2","0","0","0","0","0","0","0.000"
"1195","Ehsan Nawaz (HKG)","2016-2017","4","4","0","0","0","0","0","0","0.000"
"1196","C Emmott (Chile)","2019-2019","2","2","0","0","0","0","0","0","0.000"
"1197","RR Emrit (WI)","2018-2018","4","4","0","0","0","0","0","0","0.000"
"1198","Fakhrul Mohon (PORT)","2019-2019","4","4","0","0","0","0","0","0","0.000"
"1199","M Faraz Akram (ZIM)","2020-2020","1","1","0","0","0","0","0","0","0.000"
"1200","Fazal Niazai (AFG)","2019-2019","1","1","0","0","0","0","0","0","0.000"
"1201","H Fennell (Arg)","2019-2019","5","5","0","0","0","0","0","0","0.000"
"1202","BOP Fernando (SL)","2019-2020","6","5","0","0","0","0","0","0","0.000"
"1203","MVT Fernando (SL)","2017-2017","1","1","0","0","0","0","0","0","0.000"
"1204","Fiaz Ahmad (KUW)","2019-2019","3","3","0","0","0","0","0","0","0.000"
"1205","Fida Hussain (ITA)","2019-2019","2","2","0","0","0","0","0","0","0.000"
"1206","P Florin (ROM)","2019-2020","8","8","0","0","0","0","0","0","0.000"
"1207","KK Flowers (Blz)","2019-2019","3","3","0","0","0","0","0","0","0.000"
"1208","C Floyd (NL)","2019-2019","2","2","0","0","0","0","0","0","0.000"
"1209","AR Gandhi (KENYA)","2019-2019","3","3","0","0","0","0","0","0","0.000"
"1210","MD Garratt (GIBR)","2019-2019","4","4","0","0","0","0","0","0","0.000"
"1211","Garret Banner (Blz)","2019-2019","1","1","0","0","0","0","0","0","0.000"
"1212","A Gavde (Caym)","2019-2019","1","1","0","0","0","0","0","0","0.000"
"1213","WT Gavera (PNG)","2017-2017","3","3","0","0","0","0","0","0","0.000"
"1214","HS Gericke (MLT)","2020-2020","3","3","0","0","0","0","0","0","0.000"
"1215","L Gharasim (ROM)","2019-2020","3","3","0","0","0","0","0","0","0.000"
"1216","M Gherasim (ROM)","2020-2020","2","2","0","0","0","0","0","0","0.000"
"1217","O Goker (TKY)","2019-2019","1","1","0","0","0","0","0","0","0.000"
"1218","GF Gomes (Moz)","2019-2019","7","6","0","0","0","0","0","0","0.000"
"1219","M Goonetilleke (MLT)","2019-2019","1","1","0","0","0","0","0","0","0.000"
"1220","S Goustis ()","2019-2019","3","3","0","0","0","0","0","0","0.000"
"1221","L Gregory (ENG)","2019-2020","8","7","0","0","0","0","0","0","0.000"
"1222","Hamid Hashemi (Iran)","2020-2020","1","1","0","0","0","0","0","0","0.000"
"1223","Hamid Hassan (AFG)","2016-2016","1","1","0","0","0","0","0","0","0.000"
"1224","PSP Handscomb (AUS)","2019-2019","2","2","0","0","0","0","0","0","0.000"
"1225","Hardev Singh (Chile)","2019-2019","3","3","0","0","0","0","0","0","0.000"
"1226","Haroon Arshad (HKG)","2019-2020","17","17","0","0","0","0","0","0","0.000"
"1227","LHB Harrington-Myers (Caym)","2019-2019","4","4","0","0","0","0","0","0","0.000"
"1228","C Hartmann (IOM)","2020-2020","1","1","0","0","0","0","0","0","0.000"
"1229","Hasan Mahmud (BDESH)","2020-2020","1","1","0","0","0","0","0","0","0.000"
"1230","Hasheem Shahzad (MLT)","2019-2019","2","2","0","0","0","0","0","0","0.000"
"1231","Hassan Khan Mohammad (HKG)","2020-2020","1","1","0","0","0","0","0","0","0.000"
"1232","Hassan Rasheed (Mald)","2019-2020","11","11","0","0","0","0","0","0","0.000"
"1233","RJ Hatchman (GIBR)","2019-2019","1","1","0","0","0","0","0","0","0.000"
"1234","Hayatullah Niazi (NOR)","2019-2019","4","4","0","0","0","0","0","0","0.000"
"1235","H Helva (TKY)","2019-2019","4","4","0","0","0","0","0","0","0.000"
"1236","PD Hennessy (ESP)","2019-2020","10","10","0","0","0","0","0","0","0.000"
"1237","HMRKB Herath (SL)","2016-2016","3","3","0","0","0","0","0","0","0.000"
"1238","J Hill (PHI)","2019-2019","4","4","0","0","0","0","0","0","0.000"
"1239","H Hiri (PNG)","2019-2019","3","3","0","0","0","0","0","0","0.000"
"1240","J Hirschi (MLT)","2019-2019","4","4","0","0","0","0","0","0","0.000"
"1241","S Hongsi (THAI)","2019-2019","3","3","0","0","0","0","0","0","0.000"
"1242","EH Hutchinson (USA)","2019-2019","2","2","0","0","0","0","0","0","0.000"
"1243","Ibrahim Khan (Saudi)","2019-2019","1","1","0","0","0","0","0","0","0.000"
"1244","Ijaz Hussain (ROM)","2019-2020","5","5","0","0","0","0","0","0","0.000"
"1245","Imam-ul-Haq (PAK)","2019-2019","2","2","0","0","0","0","0","0","0.000"
"1246","Imran Bulbulia (PNM)","2019-2019","3","3","0","0","0","0","0","0","0.000"
"1247","Imran Khan (PORT)","2019-2019","4","4","0","0","0","0","0","0","0.000"
"1248","Imran Yousaf (Saudi)","2020-2020","2","2","0","0","0","0","0","0","0.000"
"1249","RK Inampud (Mex)","2019-2019","3","3","0","0","0","0","0","0","0.000"
"1250","Irfan Bhima (MWI)","2019-2019","4","4","0","0","0","0","0","0","0.000"
"1251","Irfan Mir (Chile)","2019-2019","4","4","0","0","0","0","0","0","0.000"
"1252","E Isaneez (UGA)","2019-2019","3","3","0","0","0","0","0","0","0.000"
"1253","Ishan Kishan (INDIA)","2021-2021","2","2","0","0","0","0","0","0","0.000"
"1254","Ismail Sardar (THAI)","2020-2020","2","2","0","0","0","0","0","0","0.000"
"1255","KM Jadhav (INDIA)","2016-2017","7","7","0","0","0","0","0","0","0.000"
"1256","D Jakiel (ZIM)","2019-2019","2","2","0","0","0","0","0","0","0.000"
"1257","NA Janes (THAI)","2019-2019","2","2","0","0","0","0","0","0","0.000"
"1258","T Jamtsho (BHU)","2019-2019","2","2","0","0","0","0","0","0","0.000"
"1259","Javed Ahmadi (AFG)","2017-2017","1","1","0","0","0","0","0","0","0.000"
"1260","Javed Maroofkhail (NOR)","2019-2019","2","2","0","0","0","0","0","0","0.000"
"1261","P Jayeshbhai Patel (PNM)","2019-2019","2","2","0","0","0","0","0","0","0.000"
"1262","Jay Odedra (OMAN)","2019-2019","3","3","0","0","0","0","0","0","0.000"
"1263","GJ Joseph (Blz)","2019-2019","1","1","0","0","0","0","0","0","0.000"
"1264","K Joshi (Aut)","2019-2019","5","5","0","0","0","0","0","0","0.000"
"1265","Junaid Aziz (BHR)","2020-2020","4","4","0","0","0","0","0","0","0.000"
"1266","Junaid Siddiqui (CAN)","2019-2019","5","5","0","0","0","0","0","0","0.000"
"1267","G Kaltongga (VAN)","2019-2019","3","3","0","0","0","0","0","0","0.000"
"1268","Kamran Akmal (PAK)","2017-2017","4","4","0","0","0","0","0","0","0.000"
"1269","S Kansoy (TKY)","2019-2019","4","4","0","0","0","0","0","0","0.000"
"1270","B Karki (NEPAL)","2020-2020","1","1","0","0","0","0","0","0","0.000"
"1271","S Kaul (INDIA)","2018-2019","3","3","0","0","0","0","0","0","0.000"
"1272","HB Kayondo (UGA)","2019-2019","3","3","0","0","0","0","0","0","0.000"
"1273","D Kegasitswe (Botsw)","2019-2019","4","4","0","0","0","0","0","0","0.000"
"1274","P Kerai (KENYA)","2019-2019","6","6","0","0","0","0","0","0","0.000"
"1275","Khalid Ahmadi (Belg)","2020-2020","4","4","0","0","0","0","0","0","0.000"
"1276","Khawar Zafar (Saudi)","2020-2020","2","2","0","0","0","0","0","0","0.000"
"1277","B Khumalo (Botsw)","2019-2019","3","3","0","0","0","0","0","0","0.000"
"1278","JH Kiani (PHI)","2019-2019","4","4","0","0","0","0","0","0","0.000"
"1279","VJ Kingma (NL)","2019-2019","3","3","0","0","0","0","0","0","0.000"
"1280","S Kizilkaya (TKY)","2019-2019","4","4","0","0","0","0","0","0","0.000"
"1281","D Klein (GER)","2020-2020","2","2","0","0","0","0","0","0","0.000"
"1282","N Knights (IOM)","2020-2020","1","1","0","0","0","0","0","0","0.000"
"1283","MF Koc (TKY)","2019-2019","3","3","0","0","0","0","0","0","0.000"
"1284","AC Kose (TKY)","2019-2019","4","4","0","0","0","0","0","0","0.000"
"1285","A Krishna (SGP)","2019-2020","7","7","0","0","0","0","0","0","0.000"
"1286","KMDN Kulasekara (SL)","2016-2017","9","9","0","0","0","0","0","0","0.000"
"1287","DS Kulkarni (INDIA)","2016-2016","2","2","0","0","0","0","0","0","0.000"
"1288","CBRLS Kumara (SL)","2019-2020","7","6","0","0","0","0","0","0","0.000"
"1289","T Langa (VAN)","2019-2019","1","1","0","0","0","0","0","0","0.000"
"1290","CJ Langford (IOM)","2020-2020","1","1","0","0","0","0","0","0","0.000"
"1291","C Liebenberg (IOM)","2020-2020","1","1","0","0","0","0","0","0","0.000"
"1292","I Lisboa (Chile)","2019-2019","1","1","0","0","0","0","0","0","0.000"
"1293","LS Livingstone (ENG)","2017-2017","2","2","0","0","0","0","0","0","0.000"
"1294","CA Liyanage (Mald)","2019-2020","3","3","0","0","0","0","0","0","0.000"
"1295","K Loday (BHU)","2019-2019","1","1","0","0","0","0","0","0","0.000"
"1296","L Louwrens (NAM)","2019-2019","1","1","0","0","0","0","0","0","0.000"
"1297","Lucky Ali (DEN)","2019-2019","2","2","0","0","0","0","0","0","0.000"
"1298","NM Lyon (AUS)","2018-2018","1","1","0","0","0","0","0","0","0.000"
"1299","AM McCarthy (WI)","2018-2018","1","1","0","0","0","0","0","0","0.000"
"1300","MJ McClenaghan (ICC/NZ)","2016-2018","5","5","0","0","0","0","0","0","0.000"
"1301","OC McCoy (WI)","2019-2021","5","5","0","0","0","0","0","0","0.000"
"1302","DSK Madushanka (SL)","2018-2018","2","2","0","0","0","0","0","0","0.000"
"1303","LD Madushanka (SL)","2019-2019","2","2","0","0","0","0","0","0","0.000"
"1304","R Mahajan (PHI)","2019-2019","3","3","0","0","0","0","0","0","0.000"
"1305","MF Maharoof (SL)","2016-2016","1","1","0","0","0","0","0","0","0.000"
"1306","C Mahoney (Peru)","2019-2019","3","3","0","0","0","0","0","0","0.000"
"1307","D Manani (ROM)","2019-2019","2","2","0","0","0","0","0","0","0.000"
"1308","M Markande (INDIA)","2019-2019","1","1","0","0","0","0","0","0","0.000"
"1309","D Marks (MLT)","2019-2019","2","2","0","0","0","0","0","0","0.000"
"1310","JL Martel (GUE)","2019-2019","3","3","0","0","0","0","0","0","0.000"
"1311","JC Martin (GUE)","2020-2020","1","1","0","0","0","0","0","0","0.000"
"1312","B Masaba (UGA)","2019-2020","2","2","0","0","0","0","0","0","0.000"
"1313","P Masih (ROM)","2020-2020","3","3","0","0","0","0","0","0","0.000"
"1314","Masood Jayezeh (Iran)","2020-2020","3","3","0","0","0","0","0","0","0.000"
"1315","N Master (Botsw)","2019-2019","2","2","0","0","0","0","0","0","0.000"
"1316","ZE Matsinhe (Moz)","2019-2019","7","6","0","0","0","0","0","0","0.000"
"1317","KR Mayers (WI)","2020-2020","2","1","0","0","0","0","0","0","0.000"
"1318","V Mbazo (Botsw)","2019-2019","4","4","0","0","0","0","0","0","0.000"
"1319","A McAuley (IOM)","2020-2020","1","1","0","0","0","0","0","0","0.000"
"1320","BJ McCarthy (IRE)","2017-2020","10","10","0","0","0","0","0","0","0.000"
"1321","Z McLaughlin (Caym)","2019-2019","3","3","0","0","0","0","0","0","0.000"
"1322","Mehran Dorri (Iran)","2020-2020","1","1","0","0","0","0","0","0","0.000"
"1323","Mehran Siasar (Iran)","2020-2020","1","1","0","0","0","0","0","0","0.000"
"1324","D Mejia (CRC)","2019-2019","3","3","0","0","0","0","0","0","0.000"
"1325","JH Mensah (Ghana)","2019-2019","2","2","0","0","0","0","0","0","0.000"
"1326","RP Meredith (AUS)","2021-2021","3","3","0","0","0","0","0","0","0.000"
"1327","DP Michael (Samoa)","2019-2019","4","4","0","0","0","0","0","0","0.000"
"1328","Michael Nazir (MLT)","2019-2019","1","1","0","0","0","0","0","0","0.000"
"1329","Mihusan Hamid (Mald)","2019-2019","1","1","0","0","0","0","0","0","0.000"
"1330","S Mills (IOM)","2020-2020","1","1","0","0","0","0","0","0","0.000"
"1331","Mirza Ahsan (Aut)","2019-2019","4","4","0","0","0","0","0","0","0.000"
"1332","D Mogan (MAL)","2020-2020","2","2","0","0","0","0","0","0","0.000"
"1333","Mohameed Taiwo (NGA)","2019-2019","2","2","0","0","0","0","0","0","0.000"
"1334","Mohammad Adnan (Saudi)","2019-2019","5","5","0","0","0","0","0","0","0.000"
"1335","Mohammad Ahsan (KUW)","2019-2019","6","6","0","0","0","0","0","0","0.000"
"1336","Mohammad Amir (PAK)","2016-2020","24","24","0","0","0","0","0","0","0.000"
"1337","Mohammad Ayaz (UAE)","2020-2020","1","1","0","0","0","0","0","0","0.000"
"1338","Mohammad Hasnain (PAK)","2019-2020","10","10","0","0","0","0","0","0","0.000"
"1339","Mohammad Irfan (PAK)","2016-2019","4","4","0","0","0","0","0","0","0.000"
"1340","Mohamed Mahfooz (Mald)","2019-2019","11","11","0","0","0","0","0","0","0.000"
"1341","Mohammad Shahzad (UAE)","2016-2017","5","5","0","0","0","0","0","0","0.000"
"1342","Mohammed Sameer (BHR)","2020-2020","2","2","0","0","0","0","0","0","0.000"
"1343","Mohammed Shami (INDIA)","2016-2020","8","8","0","0","0","0","0","0","0.000"
"1344","MR Montfort (CAN)","2019-2019","1","1","0","0","0","0","0","0","0.000"
"1345","VV Morea (PNG)","2017-2017","1","1","0","0","0","0","0","0","0.000"
"1346","M Morkel (SA/World)","2017-2017","5","5","0","0","0","0","0","0","0.000"
"1347","A Morris (Caym)","2019-2019","6","6","0","0","0","0","0","0","0.000"
"1348","JWN Moses (Botsw)","2019-2019","3","3","0","0","0","0","0","0","0.000"
"1349","Mohsin Hub (Peru)","2019-2019","4","4","0","0","0","0","0","0","0.000"
"1350","Mohsin Khan (HKG)","2020-2020","3","3","0","0","0","0","0","0","0.000"
"1351","Muaviath Ganee (Mald)","2019-2019","5","5","0","0","0","0","0","0","0.000"
"1352","Muhammad Ansar (KUW)","2020-2020","4","4","0","0","0","0","0","0","0.000"
"1353","Muhammad Hamayun (Saudi)","2019-2019","4","4","0","0","0","0","0","0","0.000"
"1354","Muhammad Muneeb (Belg)","2020-2020","4","4","0","0","0","0","0","0","0.000"
"1355","Muhammad Musa (PAK)","2019-2020","2","2","0","0","0","0","0","0","0.000"
"1356","Muhammad Rafique (BHR)","2019-2019","2","2","0","0","0","0","0","0","0.000"
"1357","Muhammed Shanil (UAE)","2016-2016","1","1","0","0","0","0","0","0","0.000"
"1358","Muhammad Wafiq (MAL)","2019-2019","4","4","0","0","0","0","0","0","0.000"
"1359","Mukhtiar Singh (ESP)","2019-2019","2","2","0","0","0","0","0","0","0.000"
"1360","FF Mulivai (Samoa)","2019-2019","4","4","0","0","0","0","0","0","0.000"
"1361","CT Mumba (ZIM)","2020-2020","2","2","0","0","0","0","0","0","0.000"
"1362","EMDY Munaweera (SL)","2017-2017","9","9","0","0","0","0","0","0","0.000"
"1363","S Murari (CRC)","2019-2019","3","3","0","0","0","0","0","0","0.000"
"1364","Musa Shaheen (DEN)","2019-2019","1","1","0","0","0","0","0","0","0.000"
"1365","T Muzarabani (ZIM)","2016-2016","2","2","0","0","0","0","0","0","0.000"
"1366","Nader Zahadiafzal (Iran)","2020-2020","3","3","0","0","0","0","0","0","0.000"
"1367","Naiem Bameri (Iran)","2020-2020","3","3","0","0","0","0","0","0","0.000"
"1368","A Nanda (LUX)","2019-2020","5","5","0","0","0","0","0","0","0.000"
"1369","M Nandela (Mex)","2019-2019","2","2","0","0","0","0","0","0","0.000"
"1370","A Nao (PNG)","2017-2017","2","2","0","0","0","0","0","0","0.000"
"1371","Nasrulla Rana (HKG)","2019-2020","11","11","0","0","0","0","0","0","0.000"
"1372","T Natarajan (INDIA)","2020-2020","3","3","0","0","0","0","0","0","0.000"
"1373","NH Naureen (ESP)","2019-2019","1","1","0","0","0","0","0","0","0.000"
"1374","Naveed Fakhr (KUW)","2020-2020","1","1","0","0","0","0","0","0","0.000"
"1375","Naveen-ul-Haq (AFG)","2019-2021","6","6","0","0","0","0","0","0","0.000"
"1376","Navid Balouch (Iran)","2020-2020","3","3","0","0","0","0","0","0","0.000"
"1377","Navid Abdollahpour (Iran)","2020-2020","2","2","0","0","0","0","0","0","0.000"
"1378","Nawaf Ahmed (KUW)","2019-2019","1","1","0","0","0","0","0","0","0.000"
"1379","R Neale (LUX)","2019-2019","3","3","0","0","0","0","0","0","0.000"
"1380","A Nehra (INDIA)","2016-2017","8","8","0","0","0","0","0","0","0.000"
"1381","S Nerandzic (Serb)","2019-2019","2","2","0","0","0","0","0","0","0.000"
"1382","R Ngarava (ZIM)","2019-2021","4","4","0","0","0","0","0","0","0.000"
"1383","HM Nicholls (NZ)","2016-2019","5","5","0","0","0","0","0","0","0.000"
"1384","K Nima (BHU)","2019-2019","1","1","0","0","0","0","0","0","0.000"
"1385","F Nkhoma (MWI)","2019-2019","4","4","0","0","0","0","0","0","0.000"
"1386","Noman Kamawi (Belg)","2019-2019","1","1","0","0","0","0","0","0","0.000"
"1387","A Nortje (SA)","2019-2020","5","5","0","0","0","0","0","0","0.000"
"1388","GM Ntambalika (MWI)","2019-2019","3","3","0","0","0","0","0","0","0.000"
"1389","J Nyumbu (ZIM)","2018-2018","2","2","0","0","0","0","0","0","0.000"
"1390","A Orfila (GIBR)","2019-2019","1","1","0","0","0","0","0","0","0.000"
"1391","Ovais Yousof (NGA)","2019-2019","3","3","0","0","0","0","0","0","0.000"
"1392","VS Padhaal (Fin)","2019-2019","5","5","0","0","0","0","0","0","0.000"
"1393","BA Pai (GIBR)","2019-2019","4","4","0","0","0","0","0","0","0.000"
"1394","RJG Palmer (JER)","2019-2019","2","2","0","0","0","0","0","0","0.000"
"1395","MW Parkinson (ENG)","2019-2019","2","2","0","0","0","0","0","0","0.000"
"1396","Parvez Rasool (INDIA)","2017-2017","1","1","0","0","0","0","0","0","0.000"
"1397","A Patel (MWI)","2019-2019","2","2","0","0","0","0","0","0","0.000"
"1398","AY Patel (NZ)","2018-2018","2","2","0","0","0","0","0","0","0.000"
"1399","M Patel (PNM)","2019-2019","2","2","0","0","0","0","0","0","0.000"
"1400","M Patel (Chile)","2019-2019","3","3","0","0","0","0","0","0","0.000"
"1401","MIA Patel (MWI)","2019-2019","3","3","0","0","0","0","0","0","0.000"
"1402","TK Patel (USA)","2019-2019","7","7","0","0","0","0","0","0","0.000"
"1403","N Pathan (THAI)","2019-2020","8","8","0","0","0","0","0","0","0.000"
"1404","SS Pathirana (SL)","2016-2017","5","5","0","0","0","0","0","0","0.000"
"1405","WA Peatfield (GUE)","2019-2020","9","9","0","0","0","0","0","0","0.000"
"1406","AK Perera (SL)","2019-2019","4","4","0","0","0","0","0","0","0.000"
"1407","V Permaul (WI)","2018-2018","1","1","0","0","0","0","0","0","0.000"
"1408","AM Phangiso (SA)","2016-2018","7","7","0","0","0","0","0","0","0.000"
"1409","T Phaswana (Botsw)","2019-2019","1","1","0","0","0","0","0","0","0.000"
"1410","JR Philippe (AUS)","2021-2021","5","5","0","0","0","0","0","0","0.000"
"1411","S Pillai (CRC)","2019-2019","3","3","0","0","0","0","0","0","0.000"
"1412","VRCF Poubel ()","2019-2019","3","3","0","0","0","0","0","0","0.000"
"1413","H Pragji (Botsw)","2019-2019","4","4","0","0","0","0","0","0","0.000"
"1414","C Prasad (CRC)","2019-2019","3","3","0","0","0","0","0","0","0.000"
"1415","D Pretorius (SA)","2017-2021","14","14","0","0","0","0","0","0","0.000"
"1416","SMA Priyanjan (SL)","2017-2017","3","3","0","0","0","0","0","0","0.000"
"1417","Qadeer Ahmed (UAE)","2019-2019","2","2","0","0","0","0","0","0","0.000"
"1418","Qais Ahmad (AFG)","2020-2020","1","1","0","0","0","0","0","0","0.000"
"1419","Qalandar Khan (QAT)","2019-2019","4","4","0","0","0","0","0","0","0.000"
"1420","Qasim Zia (BHR)","2019-2019","3","3","0","0","0","0","0","0","0.000"
"1421","Rahman Ademi (Serb)","2019-2019","2","2","0","0","0","0","0","0","0.000"
"1422","PBB Rajapaksa (SL)","2019-2020","7","6","0","0","0","0","0","0","0.000"
"1423","CAK Rajitha (SL)","2016-2019","8","8","0","0","0","0","0","0","0.000"
"1424","Rakibul Hasan (ITA)","2019-2019","8","7","0","0","0","0","0","0","0.000"
"1425","RLB Rambukwella (SL)","2016-2016","1","1","0","0","0","0","0","0","0.000"
"1426","SHA Rance (NZ)","2017-2019","8","7","0","0","0","0","0","0","0.000"
"1427","DA Rankin (IRE)","2016-2016","1","1","0","0","0","0","0","0","0.000"
"1428","Rashid Khan (NEPAL)","2019-2019","1","1","0","0","0","0","0","0","0.000"
"1429","KB Ratilal (PNM)","2019-2019","3","3","0","0","0","0","0","0","0.000"
"1430","Ravinder Singh (MLT)","2019-2020","5","5","0","0","0","0","0","0","0.000"
"1431","Razmal Shigiwal (Aut)","2019-2019","5","5","0","0","0","0","0","0","0.000"
"1432","J Reb (Serb)","2019-2019","2","2","0","0","0","0","0","0","0.000"
"1433","S Rengarajan (CZK-R)","2020-2020","3","3","0","0","0","0","0","0","0.000"
"1434","Riazat Ali Shah (UGA)","2019-2019","4","4","0","0","0","0","0","0","0.000"
"1435","EB Ringera (KENYA)","2019-2019","1","1","0","0","0","0","0","0","0.000"
"1436","R Rivas (Chile)","2019-2019","3","3","0","0","0","0","0","0","0.000"
"1437","CP Rizwan (UAE)","2019-2019","5","5","0","0","0","0","0","0","0.000"
"1438","Rizwan Mahmood (DEN)","2019-2019","5","3","0","0","0","0","0","0","0.000"
"1439","WJR Robertson (JER)","2019-2019","6","6","0","0","0","0","0","0","0.000"
"1440","Robert Raina (THAI)","2020-2020","4","4","0","0","0","0","0","0","0.000"
"1441","RR Rossouw (SA)","2016-2016","1","1","0","0","0","0","0","0","0.000"
"1442","Rubel Hossain (BDESH)","2017-2018","16","16","0","0","0","0","0","0","0.000"
"1443","SI Runsewe (NGA)","2019-2019","6","6","0","0","0","0","0","0","0.000"
"1444","HD Rutherford (NZ)","2019-2019","1","1","0","0","0","0","0","0","0.000"
"1445","AK Sah (NEPAL)","2018-2018","1","1","0","0","0","0","0","0","0.000"
"1446","TK Saha (Fin)","2019-2019","4","4","0","0","0","0","0","0","0.000"
"1447","Sajid Liaqat (GER)","2019-2019","2","2","0","0","0","0","0","0","0.000"
"1448","Sakib Hasan (Serb)","2019-2019","2","2","0","0","0","0","0","0","0.000"
"1449","BA Sambo (Moz)","2019-2019","2","2","0","0","0","0","0","0","0.000"
"1450","Sami Ullah (ROM)","2020-2020","1","1","0","0","0","0","0","0","0.000"
"1451","O Sam Arthur (CRC)","2019-2019","3","3","0","0","0","0","0","0","0.000"
"1452","Saqlain Ali (Belg)","2019-2019","2","2","0","0","0","0","0","0","0.000"
"1453","Saqlain Sajib (BDESH)","2016-2016","1","1","0","0","0","0","0","0","0.000"
"1454","Sayed Shirzad (AFG)","2019-2019","1","1","0","0","0","0","0","0","0.000"
"1455","Sazzad Hosen (Belg)","2020-2020","4","4","0","0","0","0","0","0","0.000"
"1456","JOP Scamans (Fin)","2019-2019","2","2","0","0","0","0","0","0","0.000"
"1457","K Senamontree (THAI)","2019-2019","2","2","0","0","0","0","0","0","0.000"
"1458","N Senamontree (THAI)","2020-2020","4","4","0","0","0","0","0","0","0.000"
"1459","SMSM Senanayake (SL)","2016-2016","2","2","0","0","0","0","0","0","0.000"
"1460","YSD Seneveratne (Caym)","2019-2019","6","6","0","0","0","0","0","0","0.000"
"1461","M Sert (TKY)","2019-2019","4","4","0","0","0","0","0","0","0.000"
"1462","L Shafeeg (Mald)","2019-2020","6","6","0","0","0","0","0","0","0.000"
"1463","Shafiul Islam (BDESH)","2017-2020","9","9","0","0","0","0","0","0","0.000"
"1464","Shahbaz Badar (BHR)","2019-2020","5","5","0","0","0","0","0","0","0.000"
"1465","Shahzad Muhammad (Mex)","2019-2019","2","2","0","0","0","0","0","0","0.000"
"1466","JNK Shannon (IRE)","2016-2018","7","7","0","0","0","0","0","0","0.000"
"1467","Shapoor Zadran (AFG)","2016-2020","11","11","0","0","0","0","0","0","0.000"
"1468","ZK Shem (VAN)","2019-2019","5","5","0","0","0","0","0","0","0.000"
"1469","Sherul Mehta (Belg)","2020-2020","1","1","0","0","0","0","0","0","0.000"
"1470","Shoaib Gazi Hossain (Chile)","2019-2019","4","4","0","0","0","0","0","0","0.000"
"1471","M Shumba (ZIM)","2020-2020","1","1","0","0","0","0","0","0","0.000"
"1472","V Sibanda (ZIM)","2016-2016","1","1","0","0","0","0","0","0","0.000"
"1473","KM Silva ()","2019-2019","3","3","0","0","0","0","0","0","0.000"
"1474","BA Simango (Moz)","2019-2019","2","2","0","0","0","0","0","0","0.000"
"1475","LA Simango (Moz)","2019-2019","3","3","0","0","0","0","0","0","0.000"
"1476","M Simmons (BMUDA)","2019-2019","2","2","0","0","0","0","0","0","0.000"
"1477","Simranjit Singh (ITA)","2019-2019","1","1","0","0","0","0","0","0","0.000"
"1478","H Singh (GER)","2019-2020","9","9","0","0","0","0","0","0","0.000"
"1479","S Singh (PHI)","2019-2019","4","4","0","0","0","0","0","0","0.000"
"1480","S Singh (PORT)","2019-2019","1","1","0","0","0","0","0","0","0.000"
"1481","JR Singleton ()","2019-2019","3","3","0","0","0","0","0","0","0.000"
"1482","T Singye (BHU)","2019-2019","2","2","0","0","0","0","0","0","0.000"
"1483","RM Siri (Arg)","2019-2019","4","4","0","0","0","0","0","0","0.000"
"1484","DC Smith (PHI)","2019-2019","4","4","0","0","0","0","0","0","0.000"
"1485","OF Smith (WI)","2018-2018","2","2","0","0","0","0","0","0","0.000"
"1486","RAJ Smith (SCOT)","2019-2019","2","2","0","0","0","0","0","0","0.000"
"1487","Sohail Khan (PAK)","2017-2017","2","2","0","0","0","0","0","0","0.000"
"1488","Sohail Tanvir (PAK)","2016-2017","7","7","0","0","0","0","0","0","0.000"
"1489","S Sohal (USA)","2019-2019","3","3","0","0","0","0","0","0","0.000"
"1490","Soheel Hussain (Belg)","2019-2019","1","1","0","0","0","0","0","0","0.000"
"1491","M Sohel Patel (PNM)","2019-2019","2","2","0","0","0","0","0","0","0.000"
"1492","S Sola (Samoa)","2019-2019","4","4","0","0","0","0","0","0","0.000"
"1493","S Soosiyakumar (BUL)","2019-2019","1","1","0","0","0","0","0","0","0.000"
"1494","ES Soto (CRC)","2019-2019","1","1","0","0","0","0","0","0","0.000"
"1495","M Spry (Peru)","2019-2019","4","4","0","0","0","0","0","0","0.000"
"1496","BB Sran (INDIA)","2016-2016","2","2","0","0","0","0","0","0","0.000"
"1497","L Sreekumar (UAE)","2017-2017","1","1","0","0","0","0","0","0","0.000"
"1498","H Ssenyondo (UGA)","2019-2020","7","7","0","0","0","0","0","0","0.000"
"1499","AJ Staal (NL)","2019-2019","9","9","0","0","0","0","0","0","0.000"
"1500","B Stanlake (AUS)","2017-2019","19","19","0","0","0","0","0","0","0.000"
"1501","AL Stephen (VAN)","2019-2019","2","2","0","0","0","0","0","0","0.000"
"1502","BS Stephenson (Blz)","2019-2019","3","3","0","0","0","0","0","0","0.000"
"1503","TJ Stephenson (Blz)","2019-2019","1","1","0","0","0","0","0","0","0.000"
"1504","GA Stuurman (SA)","2021-2021","1","1","0","0","0","0","0","0","0.000"
"1505","K Subramanian (SGP)","2020-2020","1","1","0","0","0","0","0","0","0.000"
"1506","Sufyan Mehmood (OMAN)","2019-2020","2","2","0","0","0","0","0","0","0.000"
"1507","Suhail Sadiq (LUX)","2019-2019","2","2","0","0","0","0","0","0","0.000"
"1508","Suhrid Roy (MLT)","2019-2019","1","1","0","0","0","0","0","0","0.000"
"1509","Sumair Khan (MLT)","2019-2019","1","1","0","0","0","0","0","0","0.000"
"1510","Suresh Kumar (Peru)","2019-2019","2","2","0","0","0","0","0","0","0.000"
"1511","Tafseer Ali (NOR)","2019-2019","5","5","0","0","0","0","0","0","0.000"
"1512","Taijul Islam (BDESH)","2019-2019","2","2","0","0","0","0","0","0","0.000"
"1513","Talha Khan (GER)","2019-2019","1","1","0","0","0","0","0","0","0.000"
"1514","Tariq Aziz (PORT)","2019-2019","4","4","0","0","0","0","0","0","0.000"
"1515","Tarun Sharma (Mex)","2019-2019","8","8","0","0","0","0","0","0","0.000"
"1516","Taskin Ahmed (BDESH)","2017-2018","6","6","0","0","0","0","0","0","0.000"
"1517","VE Tembo (Moz)","2019-2019","6","5","0","0","0","0","0","0","0.000"
"1518","H Thaker (CAN)","2019-2019","1","1","0","0","0","0","0","0","0.000"
"1519","J Thinley (BHU)","2019-2019","2","2","0","0","0","0","0","0","0.000"
"1520","SF Tiai (Samoa)","2019-2019","4","4","0","0","0","0","0","0","0.000"
"1521","RJW Topley (ENG)","2016-2016","1","1","0","0","0","0","0","0","0.000"
"1522","RJ Trott (BMUDA)","2019-2019","12","12","0","0","0","0","0","0","0.000"
"1523","CK Tshuma (ZIM)","2020-2020","1","1","0","0","0","0","0","0","0.000"
"1524","T Turan (TKY)","2019-2019","4","4","0","0","0","0","0","0","0.000"
"1525","HER Tyler (PHI)","2019-2019","2","2","0","0","0","0","0","0","0.000"
"1526","ML Udawatte (SL)","2017-2017","3","3","0","0","0","0","0","0","0.000"
"1527","T Ulutuna (TKY)","2019-2019","3","3","0","0","0","0","0","0","0.000"
"1528","J Umanath (Mex)","2019-2019","7","7","0","0","0","0","0","0","0.000"
"1529","Usman Shinwari (PAK)","2017-2019","14","14","0","0","0","0","0","0","0.000"
"1530","JDF Vandersay (SL)","2016-2019","6","6","0","0","0","0","0","0","0.000"
"1531","S Varathappan (KUW)","2019-2019","3","3","0","0","0","0","0","0","0.000"
"1532","DV Varghese (BUL)","2020-2020","5","4","0","0","0","0","0","0","0.000"
"1533","S Vats (LUX)","2020-2020","1","1","0","0","0","0","0","0","0.000"
"1534","S Veerapathiran (BHR)","2020-2020","1","1","0","0","0","0","0","0","0.000"
"1535","G Venkateswaran (LUX)","2019-2019","3","3","0","0","0","0","0","0","0.000"
"1536","JK Vifah (Ghana)","2019-2019","3","3","0","0","0","0","0","0","0.000"
"1537","V Vijh (LUX)","2019-2020","8","8","0","0","0","0","0","0","0.000"
"1538","Vikramjit Singh (NL)","2019-2019","1","1","0","0","0","0","0","0","0.000"
"1539","TC Vine (ESP)","2019-2020","8","8","0","0","0","0","0","0","0.000"
"1540","R Vishwanath (LUX)","2019-2019","2","2","0","0","0","0","0","0","0.000"
"1541","C Vorster (GUE)","2019-2019","1","1","0","0","0","0","0","0","0.000"
"1542","Walid Ghauri (NOR)","2019-2019","4","4","0","0","0","0","0","0","0.000"
"1543","T Wangchuk jnr (BHU)","2019-2019","2","2","0","0","0","0","0","0","0.000"
"1544","Waqar Abbasi (ROM)","2020-2020","1","1","0","0","0","0","0","0","0.000"
"1545","S Waqas Ahmed (NOR)","2019-2019","5","5","0","0","0","0","0","0","0.000"
"1546","Waqas Maqsood (PAK)","2018-2018","1","1","0","0","0","0","0","0","0.000"
"1547","Waqas Raja (Fin)","2019-2019","1","1","0","0","0","0","0","0","0.000"
"1548","Wasim Ali (OMAN)","2019-2020","3","3","0","0","0","0","0","0","0.000"
"1549","SMK Waththage (CZK-R)","2019-2019","5","5","0","0","0","0","0","0","0.000"
"1550","OJ Webster (IOM)","2020-2020","1","1","0","0","0","0","0","0","0.000"
"1551","SG Whittingham (SCOT)","2018-2018","3","3","0","0","0","0","0","0","0.000"
"1552","MA Wood (ENG)","2017-2021","13","13","0","0","0","0","0","0","0.000"
"1553","N Yordanov (BUL)","2019-2019","2","2","0","0","0","0","0","0","0.000"
"1554","Yousef Shadzehisarjou (Iran)","2020-2020","3","3","0","0","0","0","0","0","0.000"
"1555","Yuvraj Singh (INDIA)","2016-2017","6","6","0","0","0","0","0","0","0.000"
"1556","Zahid Mahmood (PAK)","2021-2021","1","1","0","0","0","0","0","0","0.000"
"1557","Zain ul Tashnam (CRC)","2019-2019","3","3","0","0","0","0","0","0","0.000"
"1558","Zakir Hasan (BDESH)","2018-2018","1","1","0","0","0","0","0","0","0.000"
"1559","Zaki Ul Hassan (Belg)","2019-2019","3","3","0","0","0","0","0","0","0.000"
"1560","S Zargar (Mex)","2019-2019","1","1","0","0","0","0","0","0","0.000"
"1561","Zeeshan Khan (MLT)","2020-2020","1","1","0","0","0","0","0","0","0.000"
"1562","Zeshan Arif (Aut)","2019-2019","3","3","0","0","0","0","0","0","0.000"
"1563","Ziaur Rahman (AFG)","2019-2019","1","1","0","0","0","0","0","0","0.000"
"1564","Ziaur Rehman (Fin)","2019-2019","1","1","0","0","0","0","0","0","0.000"
"1565","Zohaib Sarwar (PORT)","2019-2019","4","4","0","0","0","0","0","0","0.000"
"1566","Fayaz Mohammad (BUL)","2020-2020","1","-","-","-","-","-","-","-","-"
